Xv, Xv, Xv, Xv, Xv, Xv, Xv, Xv, Xv, Xv, Xv, Xv, Xv, Xv, Xv, Xv
Xv, Xv^Yyyy, Xv, Xv, Xv, Xv, Xv, Xv, Xv, Xv, Xv, Xv, Xv, Xv, Xv, Xv
Xv, Xv, Xv, Xv, Xv, Xv, Xv, Xv, Xv, Xv, Xv, Xv, Xv, Xv, Xv, Xv
Xv, Xv, Xv, Xv, Xv, Urb, Xv, Xv, Xv, Xv, Xv, Xv, Xv, Xv, Xv, Xv
Xv, Xv, Xv, Xv, Urb, Urb, Urb, Xv, Xv, Xv, Urb, Xv, Xv, Xv, Xv, Xv
Xv, Xv, Xv, Urb, Urb, 1 Urb, Urb, Urb, Urb, 2 Urb, Urb, Urb, Xv, Xv, Xv, Xv
Xv, Xv, Xv, Urb, Urb, Urb, Urb, Urb, Urb, Urb, Urb, Urb, Xv, Xv, Xv, Xv
Xv, Xv, Xv, Xv, Xv, Urb, Xv, Urb, Urb, Urb, Xv, Xv, Xv, Xv, Xv, Xv
Xv, Xv, Xv, Xv, Xv, Xv, Xv, Xv, Xv, Xv, Xv, Xv, Xv, Xv, Xv, Xv
Xv, Xv, Xv, Xv, Xv, Xv, Xv, Xv, Xv, Xv, Xv, Xv, Xv, Xv, Xv, Xv
Xv, Xv, Xv, Xv, Xv, Xv, Xv, Xv, Xv, Xv, Xv, Xv, Xv, Xv, Xv, Xv
