border_size=1
usage=map

Xv^Qov, Xv^Qov, Xv^Qov, Xv^Qov, Xv^Qov, Xv^Qov, Xv^Qov, Xv^Qov, Xv^Qov, Xv^Qov, Xv^Qov, Xv^Qov, Xv^Qov, Xv^Qov, Xv^Qov, Xv^Qov, Xv^Qov, Xv^Qov, Xv^Qov, Xv^Qov, Xv^Qov, Xv^Qov, Xv^Qov, Xv^Qov, Xv^Qov, Xv^Qov, Xv^Qov, Xv^Qov, Xv^Qov, Xv^Qov, Xv^Qov
Xv^Qov, 3 _s, Xv^Qov, Xv^Qov, Xv^Qov, Xv^Qov, Xv^Qov, Xv^Qov, Xv^Qov, Xv^Qov, Xv^Qov, Xv^Qov, Xv^Qov, Xv^Qov, Xv^Qov, Xv^Qov, Xv^Qov, Xv^Qov, Xv^Qov, Xv^Qov, Xv^Qov, Xv^Qov, Xv^Qov, Xv^Qov, Xv^Qov, Xv^Qov, Xv^Qov, Xv^Qov, Xv^Qov, Xv^Qov, Xv^Qov
Xv^Qov, Xv^Qov, Xv^Qov, Xv^Qov, Xv^Qov, Xv^Qov, Xv^Qov, Xv^Qov, Xv^Qov, Xv^Qov, Xv^Qov, Xv^Qov, Xv^Qov, Xv^Qov, Xv^Qov, Xv^Qov, Xv^Qov, Xv^Qov, Xv^Qov, Xv^Qov, Xv^Qov, Xv^Qov, Xv^Qov, Xv^Qov, Xv^Qov, Xv^Qov, Xv^Qov, Xv^Qov, Xv^Qov, Xv^Qov, Xv^Qov
Xv^Qov, Xv^Qov, Xv^Qov, Xv^Qov, Xv^Qov, Xv^Qov, Xv^Qov, Xv^Qov, Xv^Qov, Xv^Qov, Xv^Qov, Xv^Qov, Xv^Qov, Xv^Qov, Xv^Qov, Xv^Qov, Xv^Qov, Xv^Qov, Xv^Qov, Xv^Qov, Xv^Qov, Xv^Qov, Xv^Qov, Xv^Qov, Xv^Qov, Xv^Qov, Xv^Qov, Xv^Qov, Xv^Qov, Xv^Qov, Xv^Qov
Xv^Qov, Xv^Qov, Xv^Qov, Xv^Qov, Xv^Qov, Xv^Qov, Xv^Qov, Xv^Qov, Xv^Qov, Xv^Qov, Xv^Qov, Xv^Qov, Xv^Qov, Xv^Qov, Xv^Qov, Xv^Qov, Xv^Qov, Xv^Qov, Xv^Qov, Xv^Qov, Xv^Qov, Xv^Qov, Xv^Qov, Xv^Qov, Xv^Qov, Xv^Qov, Xv^Qov, Xv^Qov, Xv^Qov, Xv^Qov, Xv^Qov
Xv^Qov, Xv^Qov, Xv^Qov, Xv^Qov, Xv^Qov, Xv^Qov, Xv^Qov, Xv^Qov, Xv^Qov, Xv^Qov, Xv^Qov, Xv^Qov, Xv^Qov, Xv^Qov, Xv^Qov, Xv^Qov, Xv^Qov, Xv^Qov, Xv^Qov, Xv^Qov, Xv^Qov, Xv^Qov, Xv^Qov, Xv^Qov, Xv^Qov, Xv^Qov, Xv^Qov, Xv^Qov, Xv^Qov, Xv^Qov, Xv^Qov
Xv^Qov, Xv^Qov, Xv^Qov, Xv^Qov, Xv^Qov, Xv^Qov, Xv^Qov, Xv^Qov, Xv^Qov, Xv^Qov, Xv^Qov, Xv^Qov, Xv^Qov, Xv^Qov, Xv^Qov, Xv^Qov, Xv^Qov, Xv^Qov, Xv^Qov, Xv^Qov, Xv^Qov, Xv^Qov, Xv^Qov, Xv^Qov, Xv^Qov, Xv^Qov, Xv^Qov, Xv^Qov, Xv^Qov, Xv^Qov, Xv^Qov
Xv^Qov, Xv^Qov, Xv^Qov, Xv^Qov, Xv^Qov, Xv^Qov, Xv^Qov, Xv^Qov, Xv^Qov, Xv^Qov, Xv^Qov, Xv^Qov, Xv^Qov, Xv^Qov, Xv^Qov, Rr, Rr, Xv^Qov, Xv^Qov, Xv^Qov, Xv^Qov, Xv^Qov, Xv^Qov, Xv^Qov, Xv^Qov, Xv^Qov, Xv^Qov, Xv^Qov, Xv^Qov, Xv^Qov, Xv^Qov
Xv^Qov, Xv^Qov, Xv^Qov, Xv^Qov, Xv^Qov, Xv^Qov, Xv^Qov, Xv^Qov, Xv^Qov, Xv^Qov, Xv^Qov, Xv^Qov, Xv^Qov, Xv^Qov, Xv^Qov, Rr, Rr, Xv^Qov, Xv^Qov, Xv^Qov, Xv^Qov, Xv^Qov, Xv^Qov, Xv^Qov, Xv^Qov, Xv^Qov, Xv^Qov, Xv^Qov, Xv^Qov, Xv^Qov, Xv^Qov
Xv^Qov, Xv^Qov, Xv^Qov, Xv^Qov, Xv^Qov, Xv^Qov, Xv^Qov, Xv^Qov, Xv^Qov, Xv^Qov, Xv^Qov, Xv^Qov, Xv^Qov, Xv^Qov, Xv^Qov, Rr, Rr, Xv^Qov, Xv^Qov, Xv^Qov, Xv^Qov, Xv^Qov, Xv^Qov, Xv^Qov, Xv^Qov, Xv^Qov, Xv^Qov, Xv^Qov, Xv^Qov, Xv^Qov, Xv^Qov
Xv^Qov, Xv^Qov, Xv^Qov, Xv^Qov, Xv^Qov, Xv^Qov, Xv^Qov, Xv^Qov, Xv^Qov, Xv^Qov, Xv^Qov, Xv^Qov, Xv^Qov, Xv^Qov, Xv^Qov, Rr, Rr, Xv^Qov, Xv^Qov, Xv^Qov, Xv^Qov, Xv^Qov, Xv^Qov, Xv^Qov, Xv^Qov, Xv^Qov, Xv^Qov, Xv^Qov, Xv^Qov, Xv^Qov, Xv^Qov
Xv^Qov, Xv^Qov, Xv^Qov, Xv^Qov, Xv^Qov, Xv^Qov, Xv^Qov, Xv^Qov, Xv^Qov, Xv^Qov, Xv^Qov, Xv^Qov, Xv^Qov, Xv^Qov, Xv^Qov, Rr, Rr, Rr, Rr, Xv^Qov, Xv^Qov, Xv^Qov, Xv^Qov, Xv^Qov, Xv^Qov, Xv^Qov, Xv^Qov, Xv^Qov, Xv^Qov, Xv^Qov, Xv^Qov
Xv^Qov, Xv^Qov, Xv^Qov, Xv^Qov, Xv^Qov, Xv^Qov, Xv^Qov, Xv^Qov, Xv^Qov, Xv^Qov, Xv^Qov, Xv^Qov, Xv^Qov, Xv^Qov, Xv^Qov, Xv^Qov, Rr, Rr, Rr, Rr, Rr, Xv^Qov, Xv^Qov, Xv^Qov, Xv^Qov, Xv^Qov, Xv^Qov, Xv^Qov, Xv^Qov, Xv^Qov, Xv^Qov
Xv^Qov, Xv^Qov, Xv^Qov, Xv^Qov, Xv^Qov, Xv^Qov, Xv^Qov, Xv^Qov, Xv^Qov, Xv^Qov, Xv^Qov, Xv^Qov, Xv^Qov, Xv^Qov, Rr, Xv^Qov, Xv^Qov, Rr, Rr, Rr, Xv^Qov, Xv^Qov, Rr, Xv^Qov, Xv^Qov, Xv^Qov, Xv^Qov, Xv^Qov, Xv^Qov, Xv^Qov, Xv^Qov
Xv^Qov, Xv^Qov, Xv^Qov, Xv^Qov, Xv^Qov, Xv^Qov, Xv^Qov, Xv^Qov, Xv^Qov, Xv^Qov, Xv^Qov, Xv^Qov, Xv^Qov, Xv^Qov, Rr, Rr, Rr, Rr, Rr, Xv^Qov, Rr, Rr, Xv^Qov, Xv^Qov, Xv^Qov, Xv^Qov, Xv^Qov, Xv^Qov, Xv^Qov, Xv^Qov, Xv^Qov
Xv^Qov, Xv^Qov, Xv^Qov, Xv^Qov, Xv^Qov, Xv^Qov, Xv^Qov, Xv^Qov, Xv^Qov, Xv^Qov, Xv^Qov, Xv^Qov, Rr, Rr, Xv^Qov, Xv^Qov, Xv^Qov, Rr, Rr, Rr, Rr, Xv^Qov, Xv^Qov, Xv^Qov, Xv^Qov, Xv^Qov, Xv^Qov, Xv^Qov, Xv^Qov, Xv^Qov, Xv^Qov
Xv^Qov, Xv^Qov, Xv^Qov, Xv^Qov, Xv^Qov, Xv^Qov, Xv^Qov, Xv^Qov, Rr, Xv^Qov, Rr, Rr, Xv^Qov, Xv^Qov, Xv^Qov, Xv^Qov, Rr, Rr, Xv^Qov, Xv^Qov, Xv^Qov, Rr, Xv^Qov, Xv^Qov, Xv^Qov, Xv^Qov, Xv^Qov, Xv^Qov, Xv^Qov, Xv^Qov, Xv^Qov
Xv^Qov, Xv^Qov, Xv^Qov, Xv^Qov, Xv^Qov, Xv^Qov, Xv^Qov, Xv^Qov, Xv^Qov, Rr, Xv^Qov, Xv^Qov, Rr, Xv^Qov, Rr, Rr, Rr, Rr, Xv^Qov, Xv^Qov, Xv^Qov, Xv^Qov, Xv^Qov, Xv^Qov, Xv^Qov, Xv^Qov, Xv^Qov, Xv^Qov, Xv^Qov, Xv^Qov, Xv^Qov
Xv^Qov, Xv^Qov, Xv^Qov, Xv^Qov, Xv^Qov, Xv^Qov, Xv^Qov, Xv^Qov, Xv^Qov, Xv^Qov, Rr, Rr, Rr, Rr, Xv^Qov, Rr, Xv^Qov, Xv^Qov, Xv^Qov, Xv^Qov, Xv^Qov, Xv^Qov, Xv^Qov, Xv^Qov, Xv^Qov, Xv^Qov, Xv^Qov, Xv^Qov, Xv^Qov, Xv^Qov, Xv^Qov
Xv^Qov, Xv^Qov, Xv^Qov, Xv^Qov, Xv^Qov, Xv^Qov, Xv^Qov, Xv^Qov, Xv^Qov, Xv^Qov, Xv^Qov, Rr, Xv^Qov, Xv^Qov, Rr, Rr, Rr, Xv^Qov, Xv^Qov, Xv^Qov, Xv^Qov, Xv^Qov, Xv^Qov, Xv^Qov, Xv^Qov, Xv^Qov, Xv^Qov, Xv^Qov, Xv^Qov, Xv^Qov, Xv^Qov
Xv^Qov, Xv^Qov, Xv^Qov, Xv^Qov, Xv^Qov, Xv^Qov, Xv^Qov, Xv^Qov, Xv^Qov, Xv^Qov, Xv^Qov, Xv^Qov, Rr, Rr, Xv^Qov, 1 Xv^Qov, Xv^Qov, Xv^Qov, Xv^Qov, Xv^Qov, Xv^Qov, Xv^Qov, Xv^Qov, Xv^Qov, Xv^Qov, Xv^Qov, Xv^Qov, Xv^Qov, Rr, Xv^Qov, Xv^Qov
Xv^Qov, Xv^Qov, Xv^Qov, Xv^Qov, Xv^Qov, Xv^Qov, Xv^Qov, Xv^Qov, Xv^Qov, Xv^Qov, Xv^Qov, Rr, Rr, Rr, Xv^Qov, Xv^Qov, Xv^Qov, Xv^Qov, Rr^Cov, Rr^Cov, Rr^Cov, Xv^Qov, Xv^Qov, Xv^Qov, Xv^Qov, Xv^Qov, Rr, Rr, Rr, Xv^Qov, Xv^Qov
Xv^Qov, Xv^Qov, Xv^Qov, Xv^Qov, Xv^Qov, Xv^Qov, Xv^Qov, Xv^Qov, Xv^Qov, Xv^Qov, Xv^Qov, Rr, Rr, Rr, Rr, Rr, Rr, Rr, Rr^Cov, 2 Rr^Kov, Rr^Cov, Rr, Xv^Qov, Xv^Qov, Rr, Rr, Rr, Rr, Rr, Xv^Qov, Xv^Qov
Xv^Qov, Xv^Qov, Xv^Qov, Xv^Qov, Xv^Qov, Xv^Qov, Xv^Qov, Xv^Qov, Xv^Qov, Xv^Qov, Xv^Qov, Xv^Qov, Xv^Qov, Rr, Rr, Rr, Xv, Rr, Xv^Qov, Rr^Cov, Xv^Qov, Xv^Qov, Rr, Rr, Rr, Rr, Rr, Rr, Xv^Qov, Xv^Qov, Xv^Qov
Xv^Qov, Xv^Qov, Xv^Qov, Xv^Qov, Xv^Qov, Xv^Qov, Xv^Qov, Xv^Qov, Xv^Qov, Xv^Qov, Xv^Qov, Xv^Qov, Xv^Qov, Xv^Qov, Rr, Xv, Rr, Rr, Rr, Xv^Qov, Rr, Rr, Rr, Rr, Rr, Rr, Xv^Qov, Xv^Qov, Xv^Qov, Xv^Qov, Xv^Qov
Xv^Qov, Xv^Qov, Xv^Qov, Xv^Qov, Xv^Qov, Xv^Qov, Xv^Qov, Xv^Qov, Xv^Qov, Xv^Qov, Xv^Qov, Xv^Qov, Xv^Qov, Rr, Rr, Rr, Rr, Rr, Rr, Rr, Rr, Rr, Rr, Rr, Xv^Qov, Xv^Qov, Xv^Qov, Xv^Qov, Xv^Qov, Xv^Qov, Xv^Qov
Xv^Qov, Xv^Qov, Xv^Qov, Xv^Qov, Xv^Qov, Xv^Qov, Xv^Qov, Xv^Qov, Xv^Qov, Xv^Qov, Xv^Qov, Xv^Qov, Xv^Qov, Xv^Qov, Xv^Qov, Rr, Rr, Rr, Xv^Qov, Xv^Qov, Rr, Rr, Xv^Qov, Xv^Qov, Xv^Qov, Xv^Qov, Xv^Qov, Xv^Qov, Xv^Qov, Xv^Qov, Xv^Qov
Xv^Qov, Xv^Qov, Xv^Qov, Xv^Qov, Xv^Qov, Xv^Qov, Xv^Qov, Xv^Qov, Rr, Rr, Xv^Qov, Xv^Qov, Xv^Qov, Xv^Qov, Xv^Qov, Xv^Qov, Xv^Qov, Xv^Qov, Rr, Rr, Rr, Xv^Qov, Xv^Qov, Xv^Qov, Xv^Qov, Xv^Qov, Xv^Qov, Xv^Qov, Xv^Qov, Xv^Qov, Xv^Qov
Xv^Qov, Xv^Qov, Xv^Qov, Xv^Qov, Xv^Qov, Xv^Qov, Rr, Rr, Rr, Xv^Qov, Xv^Qov, Xv^Qov, Xv^Qov, Xv^Qov, Xv^Qov, Xv^Qov, Xv^Qov, Rr, Rr, Rr, Xv^Qov, Xv^Qov, Xv^Qov, Xv^Qov, Xv^Qov, Xv^Qov, Xv^Qov, Xv^Qov, Xv^Qov, Xv^Qov, Xv^Qov
Xv^Qov, Xv^Qov, Xv^Qov, Xv^Qov, Rr, Rr, Rr, Rr, Rr, Rr, Rr, Xv^Qov, Xv^Qov, Xv^Qov, Xv^Qov, Xv^Qov, Rr, Rr, Xv^Qov, Xv^Qov, Xv^Qov, Xv^Qov, Xv^Qov, Xv^Qov, Xv^Qov, Xv^Qov, Xv^Qov, Xv^Qov, Xv^Qov, Xv^Qov, Xv^Qov
Xv^Qov, Xv^Qov, Rr, Rr, Rr, Rr, Rr, Rr, Rr, Rr, Rr, Rr, Rr, Xv^Qov, Xv^Qov, Xv^Qov, Rr, Rr, Xv^Qov, Xv^Qov, Xv^Qov, Xv^Qov, Xv^Qov, Xv^Qov, Xv^Qov, Xv^Qov, Xv^Qov, Xv^Qov, Xv^Qov, Xv^Qov, Xv^Qov
Xv^Qov, Xv^Qov, Rr, Rr, Rr, Rr, Rr, Rr, Rr, Rr, Rr, Rr, Rr, Rr, Rr, Rr, Rr, Xv^Qov, Xv^Qov, Xv^Qov, Xv^Qov, Xv^Qov, Xv^Qov, Xv^Qov, Xv^Qov, Xv^Qov, Xv^Qov, Xv^Qov, Xv^Qov, Xv^Qov, Xv^Qov
Xv^Qov, Xv^Qov, Rr, Rr, Rr, Rr, Rr, Rr, Rr, Rr, Rr, Rr, Rr, Rr, Rr, Rr, Xv^Qov, Xv^Qov, Xv^Qov, Xv^Qov, Xv^Qov, Xv^Qov, Xv^Qov, Xv^Qov, Xv^Qov, Xv^Qov, Xv^Qov, Xv^Qov, Xv^Qov, Xv^Qov, Xv^Qov
Xv^Qov, Xv^Qov, Rr, Rr, Rr, Rr, Rr, Rr, Rr, Rr, Rr, Rr, Rr, Rr, Xv^Qov, Xv^Qov, Xv^Qov, Xv^Qov, Xv^Qov, Xv^Qov, Xv^Qov, Xv^Qov, Xv^Qov, Xv^Qov, Xv^Qov, Xv^Qov, Xv^Qov, Xv^Qov, Xv^Qov, Xv^Qov, Xv^Qov
Xv^Qov, Xv^Qov, Xv^Qov, Xv^Qov, Rr, Rr, Xv, Xv, Rr, Rr, Xv^Qov, Xv^Qov, Xv^Qov, Xv^Qov, Xv^Qov, Xv^Qov, Xv^Qov, Xv^Qov, Xv^Qov, Xv^Qov, Xv^Qov, Xv^Qov, Xv^Qov, Xv^Qov, Xv^Qov, Xv^Qov, Xv^Qov, Xv^Qov, Xv^Qov, Xv^Qov, Xv^Qov
Xv^Qov, Xv^Qov, Rr, Xv^Qov, Rr, Rr, Rr, Xv, Rr, Rr, Rr, Xv^Qov, Xv^Qov, Xv^Qov, Xv^Qov, Xv^Qov, Xv^Qov, Xv^Qov, Xv^Qov, Xv^Qov, Xv^Qov, Xv^Qov, Xv^Qov, Xv^Qov, Xv^Qov, Xv^Qov, Xv^Qov, Xv^Qov, Xv^Qov, Xv^Qov, Xv^Qov
Xv^Qov, Xv^Qov, Rr, Rr, Rr, Rr, Rr, Rr, Rr, Rr, Rr, Rr, Xv^Qov, Xv^Qov, Xv^Qov, Xv^Qov, Xv^Qov, Xv^Qov, Xv^Qov, Xv^Qov, Xv^Qov, Xv^Qov, Xv^Qov, Xv^Qov, Xv^Qov, Xv^Qov, Xv^Qov, Xv^Qov, Xv^Qov, Xv^Qov, Xv^Qov
Xv^Qov, Xv^Qov, Rr, Rr, Rr, Rr, Rr, Rr, Rr, Rr, Rr, Rr, Xv^Qov, Xv^Qov, Xv^Qov, Xv^Qov, Xv^Qov, Xv^Qov, Xv^Qov, Xv^Qov, Xv^Qov, Xv^Qov, Xv^Qov, Xv^Qov, Xv^Qov, Xv^Qov, Xv^Qov, Xv^Qov, Xv^Qov, Xv^Qov, Xv^Qov
Xv^Qov, Xv^Qov, Rr, Rr, Rr, Rr, Rr, Rr, Rr, Rr, Rr, Rr, Xv^Qov, Xv^Qov, Xv^Qov, Xv^Qov, Xv^Qov, Xv^Qov, Xv^Qov, Xv^Qov, Xv^Qov, Xv^Qov, Xv^Qov, Xv^Qov, Xv^Qov, Xv^Qov, Xv^Qov, Xv^Qov, Xv^Qov, Xv^Qov, Xv^Qov
Xv^Qov, Xv^Qov, Rr, Rr, Rr, Rr, Rr, Rr, Rr, Rr, Rr, Rr, Xv^Qov, Xv^Qov, Xv^Qov, Xv^Qov, Xv^Qov, Xv^Qov, Xv^Qov, Xv^Qov, Xv^Qov, Xv^Qov, Xv^Qov, Xv^Qov, Xv^Qov, Xv^Qov, Xv^Qov, Xv^Qov, Xv^Qov, Xv^Qov, Xv^Qov
Xv^Qov, Xv^Qov, Rr, Rr, Rr, Rr, Rr, Rr, Rr, Rr, Rr, Rr, Xv^Qov, Xv^Qov, Xv^Qov, Xv^Qov, Xv^Qov, Xv^Qov, Xv^Qov, Xv^Qov, Xv^Qov, Xv^Qov, Xv^Qov, Xv^Qov, Xv^Qov, Xv^Qov, Xv^Qov, Xv^Qov, Xv^Qov, Xv^Qov, Xv^Qov
Xv^Qov, Xv^Qov, Rr, Rr, Rr, Rr, Rr, Rr, Rr, Rr, Rr, Rr, Xv^Qov, Xv^Qov, Xv^Qov, Xv^Qov, Xv^Qov, Xv^Qov, Xv^Qov, Xv^Qov, Xv^Qov, Xv^Qov, Xv^Qov, Xv^Qov, Xv^Qov, Xv^Qov, Xv^Qov, Xv^Qov, Xv^Qov, Xv^Qov, Xv^Qov
