Qxu, Xv, Qxu, Xv, Qxu, Xv, Qxu, Xv, Qxu, Xv, Qxu, Xv, Qxu, Xv, Qxu, Xv, Qxu, Xv, Qxu, Xv, Qxu, Xv, Qxu, Xv, Qxu, Xv, Qxu, Xv, Qxu, Xv, Qxu, Xv, Qxu, Xv, Qxu, Xv, Qxu, Xv, Qxu, Xv, Qxu, Xv, Qxu, Xv, Qxu, Xv
Qxu^Qov, Qxu^Yyyy, Qxu^Qov, Qxu, Qxu^Qov, Qxu, Qxu^Qov, Qxu, Qxu^Qov, Qxu, Qxu^Qov, Qxu, Qxu^Qov, Qxu, Qxu^Qov, Qxu, Qxu^Qov, Qxu, Ur, Ur, Ur, Qxu, Qxu^Qov, Qxu, Qxu^Qov, Qxu, Qxu^Qov, Qxu, Qxu^Qov, Qxu, Qxu^Qov, Qxu, Qxu^Qov, Qxu, Qxu^Qov, Qxu, Qxu^Qov, Qxu, Qxu^Qov, Qxu, Qxu^Qov, Qxu, Qxu^Qov, Qxu, Qxu^Qov, Qxu
Qxu^Qov, Qxu^Qov, Qxu^Qov, Qxu^Qov, Qxu^Qov, Qxu^Qov, Qxu^Qov, Qxu^Qov, Qxu^Qov, Qxu^Qov, Qxu^Qov, Qxu^Qov, Qxu^Qov, Qxu^Qov, Qxu^Qov, Qxu^Qov, Qxu^Qov, Ur, Qxu^Qov, Qxu^Qov, Qxu^Qov, Ur, Uu, Qxu^Qov, Qxu^Qov, Qxu^Qov, Qxu^Qov, Qxu^Qov, Qxu^Qov, Qxu^Qov, Qxu^Qov, Qxu^Qov, Qxu^Qov, Qxu^Qov, Qxu^Qov, Qxu^Qov, Qxu^Qov, Qxu^Qov, Qxu^Qov, Qxu^Qov, Qxu^Qov, Qxu^Qov, Qxu^Qov, Qxu^Qov, Qxu^Qov, Qxu^Qov
Qxu^Qov, Qxu^Qov, Qxu^Qov, Qxu^Qov, Qxu^Qov, Qxu^Qov, Qxu^Qov, Qxu^Qov, Qxu^Qov, Qxu^Qov, Qxu^Qov, Qxu^Qov, Qxu^Qov, Qxu^Qov, Qxu^Qov, Qxu^Qov, Ur, Ur, Qxu^Qov, Qxu^Qov, Qxu^Qov, Qxu^Qov, Qxu^Qov, Uu, Qxu^Qov, Qxu^Qov, Qxu^Qov, Qxu^Qov, Qxu^Qov, Qxu^Qov, Qxu^Qov, Qxu^Qov, Qxu^Qov, Qxu^Qov, Qxu^Qov, Qxu^Qov, Qxu^Qov, Qxu^Qov, Qxu^Qov, Qxu^Qov, Qxu^Qov, Qxu^Qov, Qxu^Qov, Qxu^Qov, Qxu^Qov, Qxu^Qov
Qxu^Qov, Qxu^Qov, Qxu^Qov, Qxu^Qov, Qxu^Qov, Qxu^Qov, Qxu^Qov, Qxu^Qov, Qxu^Qov, Qxu^Qov, Qxu^Qov, Qxu^Qov, Qxu^Qov, Qxu^Qov, Qxu^Qov, Ur, Qxu^Qov, Qxu^Qov, Qxu^Qov, Qxu^Qov, Qxu^Qov, Qxu^Qov, Qxu^Qov, Qxu^Qov, Qxu^Qov, Qxu^Qov, Qxu^Qov, Qxu^Qov, Qxu^Qov, Qxu^Qov, Qxu^Qov, Qxu^Qov, Qxu^Qov, Qxu^Qov, Qxu^Qov, Qxu^Qov, Qxu^Qov, Qxu^Qov, Qxu^Qov, Qxu^Qov, Qxu^Qov, Qxu^Qov, Qxu^Qov, Qxu^Qov, Qxu^Qov, Qxu^Qov
Qxu^Qov, Qxu^Qov, Qxu^Qov, Qxu^Qov, Qxu^Qov, Qxu^Qov, Qxu^Qov, Qxu^Qov, Qxu^Qov, Qxu^Qov, Qxu^Qov, Qxu^Qov, Qxu^Qov, Qxu^Qov, Ur, Ur, Qxu^Qov, Qxu^Qov, Qxu^Qov, Qxu^Qov, Qxu^Qov, Qxu^Qov, Qxu^Qov, Qxu^Qov, Qxu^Qov, Qxu^Qov, Qxu^Qov, Qxu^Qov, Qxu^Qov, Qxu^Qov, Qxu^Qov, Qxu^Qov, Qxu^Xo, Qxu^Qov, Qxu^Qov, Qxu^Qov, Qxu^Qov, Qxu^Qov, Qxu^Qov, Qxu^Qov, Qxu^Qov, Qxu^Qov, Qxu^Qov, Qxu^Qov, Qxu^Qov, Qxu^Qov
Qxu^Qov, Qxu^Qov, Qxu^Qov, Qxu^Qov, Qxu^Qov, Qxu^Qov, Qxu^Qov, Qxu^Qov, Qxu^Qov, Qxu^Qov, Qxu^Qov, Qxu^Qov, Qxu^Qov, Qxu^Qov, Ur, Qxu^Qov, Qxu^Qov, Qxu^Qov, Qxu^Qov, Qxu^Qov, Qxu^Qov, Qxu^Qov, Qxu^Qov, Qxu^Qov, Qxu^Qov, Qxu^Qov, Qxu^Qov, Qxu^Qov, Qxu^Qov, Qxu^Qov, Qxu^Qov, Qxu^Xo, Qxu^Xo, Qxu^Xo, Qxu^Qov, Qxu^Qov, Qxu^Qov, Qxu^Qov, Qxu^Qov, Qxu^Qov, Qxu^Qov, Qxu^Qov, Qxu^Qov, Qxu^Qov, Qxu^Qov, Qxu^Qov
Qxu^Qov, Qxu^Qov, Qxu^Qov, Qxu^Qov, Qxu^Qov, Qxu^Qov, Qxu^Qov, Qxu^Qov, Qxu^Qov, Qxu^Qov, Qxu^Qov, Qxu^Qov, Ur, Ur, Qxu^Qov, Qxu^Qov, Qxu^Qov, Qxu^Qov, Qxu^Qov, Qxu^Qov, Qxu^Qov, Qxu^Qov, Qxu^Qov, Qxu^Qov, Qxu^Qov, Qxu^Qov, Qxu^Qov, Qxu^Qov, Qxu^Qov, Qxu^Qov, Qxu^Qov, Qxu^Xo, Qxu^Xo, Qxu^Xo, Qxu^Qov, Qxu^Qov, Qxu^Qov, Qxu^Qov, Qxu^Qov, Qxu^Qov, Qxu^Qov, Qxu^Qov, Qxu^Qov, Qxu^Qov, Qxu^Qov, Qxu^Qov
Qxu^Qov, Qxu^Qov, Qxu^Qov, Qxu^Qov, Qxu^Qov, Qxu^Qov, Qxu^Qov, Qxu^Qov, Qxu^Qov, Qxu^Qov, Qxu^Qov, Qxu^Qov, Ur, Qxu^Qov, Qxu^Qov, Qxu^Qov, Qxu^Qov, Qxu^Qov, Qxu^Qov, Qxu^Qov, Qxu^Qov, Qxu^Qov, Qxu^Qov, Qxu^Qov, Qxu^Qov, Qxu^Qov, Qxu^Qov, Qxu^Qov, Qxu^Qov, Qxu^Qov, Qxu^Qov, Qxu^Qov, Qxu^Qov, Qxu^Qov, Qxu^Qov, Qxu^Qov, Qxu^Qov, Qxu^Qov, Qxu^Qov, Qxu^Qov, Qxu^Qov, Qxu^Qov, Qxu^Qov, Qxu^Qov, Qxu^Qov, Qxu^Qov
Qxu^Qov, Qxu^Qov, Qxu^Qov, Qxu^Qov, Qxu^Qov, Qxu^Qov, Qxu^Qov, Qxu^Qov, Qxu^Qov, Qxu^Qov, Qxu^Qov, Ur, Qxu^Qov, Qxu^Qov, Qxu^Qov, Qxu^Qov, Qxu^Qov, Qxu^Qov, Qxu^Qov, Qxu^Qov, Qxu^Qov, Qxu^Qov, Qxu^Qov, Qxu^Qov, Qxu^Qov, Qxu^Qov, Qxu^Qov, Qxu^Qov, Qxu^Qov, Qxu^Qov, Qxu^Qov, Qxu^Qov, Qxu^Qov, Qxu^Qov, Qxu^Qov, Qxu^Qov, Qxu^Qov, Qxu^Qov, Qxu^Qov, Qxu^Qov, Qxu^Qov, Qxu^Qov, Qxu^Qov, Qxu^Qov, Qxu^Qov, Qxu^Qov
Qxu^Qov, Qxu^Qov, Qxu^Qov, Qxu^Qov, Qxu^Qov, Qxu^Qov, Qxu^Qov, Qxu^Qov, Qxu^Qov, Qxu^Qov, Ur, Ur, Qxu^Qov, Qxu^Qov, Qxu^Qov, Qxu^Qov, Qxu^Qov, Qxu^Qov, Qxu^Qov, Qxu^Qov, Qxu^Qov, Qxu^Qov, Qxu^Qov, Qxu^Qov, Qxu^Qov, Qxu^Qov, Qxu^Qov, Qxu^Qov, Qxu^Qov, Qxu^Qov, Qxu^Qov, Qxu^Qov, Qxu^Qov, Qxu^Qov, Qxu^Qov, Qxu^Qov, Qxu^Qov, Qxu^Qov, Qxu^Qov, Qxu^Qov, Qxu^Qov, Qxu^Qov, Qxu^Qov, Qxu^Qov, Qxu^Qov, Qxu^Qov
Qxu^Qov, Qxu^Qov, Qxu^Qov, Qxu^Qov, Qxu^Qov, Qxu^Qov, Qxu^Qov, Qxu^Qov, Qxu^Qov, Ur, Qxu^Qov, Qxu^Qov, Qxu^Qov, Qxu^Qov, Qxu^Qov, Qxu^Qov, Qxu^Qov, Qxu^Qov, Qxu^Qov, Qxu^Qov, Qxu^Qov, Qxu^Qov, Qxu^Qov, Qxu^Qov, Qxu^Qov, Qxu^Qov, Qxu^Qov, Qxu^Qov, Qxu^Qov, Qxu^Qov, Qxu^Qov, Qxu^Qov, Qxu^Qov, Qxu^Qov, Qxu^Qov, Qxu^Qov, Qxu^Qov, Qxu^Qov, Qxu^Qov, Qxu^Qov, Qxu^Qov, Qxu^Qov, Qxu^Qov, Qxu^Qov, Qxu^Qov, Qxu^Qov
Qxu^Qov, Qxu^Qov, Qxu^Qov, Qxu^Qov, Qxu^Qov, Qxu^Qov, Qxu^Qov, Qxu^Qov, Ur, Ur, Qxu^Qov, Qxu^Qov, Qxu^Qov, Qxu^Qov, Qxu^Qov, Qxu^Qov, Qxu^Qov, Qxu^Qov, Qxu^Qov, Qxu^Qov, Qxu^Qov, Qxu^Qov, Qxu^Qov, Qxu^Qov, Qxu^Qov, Qxu^Qov, Qxu^Qov, Qxu^Qov, Qxu^Qov, Qxu^Qov, Qxu^Qov, Qxu^Qov, Qxu^Qov, Qxu^Qov, Qxu^Qov, Qxu^Qov, Qxu^Qov, Qxu^Qov, Qxu^Qov, Qxu^Qov, Qxu^Xo, Qxu^Qov, Qxu^Qov, Qxu^Qov, Qxu^Qov, Qxu^Qov
Qxu^Qov, Qxu^Qov, Qxu^Qov, Qxu^Qov, Qxu^Qov, Qxu^Qov, Qxu^Qov, Qxu^Qov, Ur, Qxu^Qov, Qxu^Qov, Qxu^Qov, Qxu^Qov, Qxu^Qov, Qxu^Qov, Qxu^Qov, Qxu^Qov, Qxu^Qov, Qxu^Qov, Qxu^Qov, Qxu^Qov, Qxu^Qov, Qxu^Qov, Qxu^Qov, Qxu^Qov, Qxu^Qov, Qxu^Qov, Qxu^Qov, Qxu^Qov, Qxu^Qov, Qxu^Qov, Qxu^Qov, Qxu^Qov, Qxu^Qov, Qxu^Qov, Qxu^Qov, Qxu^Qov, Qxu^Qov, Qxu^Xo, Qxu^Xo, Qxu^Qov, Qxu^Xo, Qxu^Qov, Qxu^Qov, Qxu^Qov, Qxu^Qov
Qxu^Qov, Qxu^Qov, Qxu^Qov, Qxu^Qov, Qxu^Qov, Qxu^Qov, Ur, Ur, Qxu^Qov, Qxu^Qov, Qxu^Qov, Qxu^Qov, Qxu^Qov, Qxu^Qov, Qxu^Qov, Qxu^Qov, Qxu^Qov, Qxu^Qov, Qxu^Qov, Qxu^Qov, Qxu^Qov, Qxu^Qov, Qxu^Qov, Qxu^Qov, Qxu^Qov, Qxu^Qov, Qxu^Qov, Qxu^Qov, Qxu^Qov, Qxu^Qov, Qxu^Qov, Qxu^Qov, Qxu^Qov, Qxu^Qov, Qxu^Qov, Qxu^Qov, Qxu^Qov, Qxu^Qov, Qxu^Xo, Qxu^Qov, Qxu^Qov, Qxu^Xo, Qxu^Qov, Qxu^Qov, Qxu^Qov, Qxu^Qov
Qxu^Qov, Qxu^Qov, Qxu^Qov, Qxu^Qov, Qxu^Qov, Qxu^Qov, Ur, Qxu^Qov, Qxu^Qov, Qxu^Qov, Qxu^Qov, Qxu^Qov, Qxu^Qov, Qxu^Qov, Qxu^Qov, Qxu^Qov, Qxu^Qov, Qxu^Qov, Qxu^Qov, Qxu^Qov, Qxu^Qov, Qxu^Qov, Qxu^Qov, Qxu^Qov, Qxu^Qov, Qxu^Qov, Qxu^Qov, Qxu^Qov, Qxu^Qov, Qxu^Qov, Qxu^Qov, Qxu^Qov, Qxu^Qov, Qxu^Qov, Qxu^Qov, Qxu^Qov, Qxu^Qov, Qxu^Qov, Qxu^Qov, Qxu^Xo, Qxu^Xo, Qxu^Xo, Qxu^Qov, Qxu^Qov, Qxu^Qov, Qxu^Qov
Qxu^Qov, Qxu^Qov, Qxu^Qov, Qxu^Qov, Qxu^Qov, Ur, Qxu^Qov, Uh, Qxu^Qov, Qxu^Qov, Ur, Qxu^Qov, Ur, Qxu^Qov, Ur, Qxu^Qov, Qxu^Qov, Qxu^Qov, Qxu^Qov, Qxu^Qov, Qxu^Qov, Qxu^Qov, Qxu^Qov, Qxu^Qov, Qxu^Qov, Qxu^Qov, Qxu^Qov, Qxu^Qov, Qxu^Qov, Qxu^Qov, Qxu^Qov, Qxu^Qov, Qxu^Qov, Qxu^Qov, Qxu^Qov, Qxu^Qov, Qxu^Qov, Qxu^Qov, Qxu^Qov, Qxu^Qov, Qxu^Qov, Qxu^Qov, Qxu^Qov, Qxu^Qov, Qxu^Qov, Qxu^Qov
Qxu^Qov, Qxu^Qov, Qxu^Qov, Qxu^Qov, Qxu^Qov, Ur, Qxu^Qov, Uh, Ur, Ur, Ur, Ur, Ur, Ur, Qxu^Qov, Qxu^Qov, Qxu^Qov, Qxu^Qov, Qxu^Qov, Qxu^Qov, Qxu^Qov, Qxu^Qov, Qxu^Qov, Qxu^Qov, Qxu^Qov, Qxu^Qov, Ur, Ur, Ur, Qxu^Qov, Qxu^Qov, Qxu^Qov, Qxu^Qov, Qxu^Qov, Qxu^Qov, Qxu^Qov, Qxu^Qov, Qxu^Qov, Qxu^Qov, Qxu^Qov, Qxu^Qov, Qxu^Qov, Qxu^Qov, Qxu^Qov, Qxu^Qov, Qxu^Qov
Qxu^Qov, Qxu^Qov, Qxu^Qov, Qxu^Qov, Qxu^Qov, Qxu^Qov, Qxu^Qov, Qxu^Qov, Qxu^Qov, Ur, Ur, Ur, Qxu^Qov, Qxu^Qov, Qxu^Qov, Qxu^Qov, Qxu^Qov, Qxu^Qov, Qxu^Qov, Qxu^Qov, Qxu^Qov, Qxu^Qov, Qxu^Qov, Qxu^Qov, Ur^Kov, Ur^Kov, Ur^Vov, Ur, Ur, Ur, Ur, Qxu^Qov, Qxu^Qov, Qxu^Qov, Qxu^Qov, Qxu^Qov, Qxu^Qov, Qxu^Qov, Qxu^Qov, Qxu^Qov, Qxu^Qov, Qxu^Qov, Qxu^Qov, Qxu^Qov, Qxu^Qov, Qxu^Qov
Qxu^Qov, Qxu^Qov, Qxu^Qov, Qxu^Qov, Qxu^Qov, Qxu^Qov, Qxu^Qov, Qxu^Qov, Qxu^Qov, Qxu^Qov, Qxu^Qov, Qxu^Qov, Qxu^Qov, Qxu^Qov, Qxu^Qov, Qxu^Qov, Qxu^Qov, Qxu^Qov, Qxu^Qov, Qxu^Qov, Ur^Cov, Qxu^Qov, Ur, Ur^Vov, Ur^Kov, Ur^Kov, Ur^Kov, Ur, 2 Ur, Ur, Ur, Ur, Ur, Qxu^Qov, Qxu^Qov, Qxu^Qov, Qxu^Qov, Qxu^Qov, Qxu^Qov, Qxu^Qov, Qxu^Qov, Qxu^Qov, Qxu^Qov, Qxu^Qov, Qxu^Qov, Qxu^Qov
Qxu^Qov, Qxu^Qov, Qxu^Qov, Qxu^Qov, Qxu^Qov, Qxu^Qov, Qxu^Qov, Qxu^Qov, Qxu^Qov, Qxu^Qov, Qxu^Qov, Qxu^Qov, Qxu^Qov, Qxu^Qov, Qxu^Qov, Qxu^Qov, Qxu^Qov, Qxu^Qov, Qxu^Qov, Qxu^Qov, Ur, Ur, Ur, Ur^Kov, Ur, Ur^Vov, Ur, Ur, Ur, Ur, Ur, Ur, Ur, Ur, Ur, Qxu^Qov, Qxu^Qov, Qxu^Qov, Qxu^Qov, Qxu^Qov, Qxu^Qov, Qxu^Qov, Qxu^Qov, Qxu^Qov, Qxu^Qov, Qxu^Qov
Qxu^Qov, Qxu^Qov, Qxu^Qov, Qxu^Qov, Qxu^Qov, Qxu^Qov, Qxu^Qov, Qxu^Qov, Qxu^Qov, Qxu^Qov, Qxu^Qov, Qxu^Qov, Qxu^Qov, Qxu^Qov, Qxu^Qov, Qxu^Qov, Qxu^Qov, Qxu^Qov, Ur, Ur, Ur, Ur, Ur, Ur, Ur, Ur, Ur, Ur, Ur, Ur^Kov, Ur^Kov, Ur^Vov, Ur^Kov, Ur, Ur, Ur, Qxu^Qov, Qxu^Qov, Qxu^Qov, Qxu^Qov, Qxu^Qov, Qxu^Qov, Qxu^Qov, Qxu^Qov, Qxu^Qov, Qxu^Qov
Qxu^Qov, Qxu^Qov, Qxu^Qov, Qxu^Qov, Qxu^Qov, Qxu^Qov, Qxu^Qov, Qxu^Qov, Qxu^Qov, Qxu^Qov, Qxu^Qov, Qxu^Qov, Qxu^Qov, Qxu^Qov, Qxu^Qov, Ur^Cov, Ur, Ur, Ur, Ur, Ur, Ur, Ur, Ur, Ur, Ur, Ur, Ur, Ur^Kov, Ur^Kov, Ur^Vov, Ur^Kov, Qxu^Qov, Qxu^Qov, Ur, Qxu^Qov, Qxu^Qov, Qxu^Qov, Qxu^Qov, Qxu^Qov, Qxu^Qov, Qxu^Qov, Qxu^Qov, Qxu^Qov, Qxu^Qov, Qxu^Qov
Qxu^Qov, Qxu^Qov, Qxu^Qov, Qxu^Qov, Qxu^Qov, Qxu^Qov, Qxu^Qov, Qxu^Qov, Qxu^Qov, Qxu^Qov, Qxu^Qov, Qxu^Qov, Qxu^Qov, Qxu^Qov, Ur, Ur, Ur, Ur, Ur, Ur, Ur, Ur, Ur, Ur, Ur, Ur, Ur, Ur, Ur, Ur, Qxu^Qov, Qxu^Qov, Ur, Ur, Qxu^Qov, Qxu^Qov, Qxu^Qov, Qxu^Qov, Qxu^Qov, Qxu^Qov, Qxu^Qov, Qxu^Qov, Qxu^Qov, Qxu^Qov, Qxu^Qov, Qxu^Qov
Qxu^Qov, Qxu^Qov, Qxu^Qov, Qxu^Qov, Qxu^Qov, Qxu^Qov, Qxu^Qov, Qxu^Qov, Qxu^Qov, Qxu^Qov, Ur^Cov, Qxu^Qov, Ur, Ur, Ur, Ur, Ur, Ur, Ur, Ur, Ur, Ur, Ur, Ur, Ur, Ur, Ur, Ur, Qxu^Qov, Ur^Cov, Qxu^Qov, Qxu^Qov, Ur, Qxu^Qov, Qxu^Qov, Qxu^Qov, Qxu^Qov, Qxu^Qov, Qxu^Qov, Qxu^Qov, Qxu^Qov, Qxu^Qov, Qxu^Qov, Qxu^Qov, Qxu^Qov, Qxu^Qov
Qxu^Qov, Qxu^Qov, Qxu^Qov, Qxu^Qov, Qxu^Qov, Qxu^Qov, Qxu^Qov, Qxu^Qov, Qxu^Qov, Qxu^Qov, Ur, Ur, Ur, Ur, Ur, Ur, Ur, Ur, Ur, Ur, Ur, Ur, Ur, Ur, Ur, Ur, Qxu^Qov, Qxu^Qov, Qxu^Qov, Qxu^Qov, Ur, Ur, Qxu^Qov, Qxu^Qov, Qxu^Qov, Qxu^Qov, Qxu^Qov, Qxu^Qov, Qxu^Qov, Qxu^Qov, Qxu^Qov, Qxu^Qov, Qxu^Qov, Qxu^Qov, Qxu^Qov, Qxu^Qov
Qxu^Qov, Qxu^Qov, Qxu^Qov, Qxu^Qov, Qxu^Qov, Qxu^Qov, Qxu^Qov, Qxu^Qov, Ur, Ur, Ur, Ur, Ur, Ur, Ur, Ur, Ur, Ur, Ur, Ur, Ur, Ur, Ur, Ur, Ur^Cov, Qxu^Qov, Ur, Ur, Ur, Ur, Ur, Ur, Qxu^Qov, Qxu^Qov, Qxu^Qov, Qxu^Qov, Qxu^Qov, Qxu^Qov, Qxu^Qov, Qxu^Qov, Qxu^Qov, Qxu^Qov, Qxu^Qov, Qxu^Qov, Qxu^Qov, Qxu^Qov
Qxu^Qov, Qxu^Qov, Qxu^Qov, Qxu^Qov, Qxu^Qov, Qxu^Qov, Ur, Ur, Ur, Ur, Ur, Ur, Ur, Ur, Ur, Ur, Ur, Ur, Ur, Ur, Ur, Ur, Qxu^Qov, Qxu^Qov, Qxu^Qov, Qxu^Qov, Ur, Ur, Ur, Ur, Ur, Qxu^Qov, Qxu^Qov, Qxu^Qov, Qxu^Qov, Qxu^Qov, Qxu^Qov, Qxu^Qov, Qxu^Qov, Qxu^Qov, Qxu^Qov, Qxu^Qov, Qxu^Qov, Qxu^Qov, Qxu^Qov, Qxu^Qov
Qxu^Qov, Qxu^Qov, Qxu^Qov, Qxu^Qov, Ur, Ur, Ur, Ur, Ur, Ur, Ur, Ur, Ur, Ur, Ur, Ur, Ur, Ur, Ur, Ur, Qxu^Qov, Qxu^Qov, Ur, Ur, Ur, Ur, Ur, Ur, Qxu^Qov, Qxu^Qov, Qxu^Qov, Ur, Ur, Ur, Ur, Qxu^Qov, Qxu^Qov, Qxu^Qov, Qxu^Qov, Qxu^Qov, Qxu^Qov, Qxu^Qov, Qxu^Qov, Qxu^Qov, Qxu^Qov, Qxu^Qov
Qxu^Qov, Qxu^Qov, Ur^Kov, Ur, Ur, Ur, Ur, Ur, Ur, Ur, Ur, Ur, Ur, Ur, Ur, Ur, Ur, Ur, Qxu^Qov, Ur^Cov, Qxu^Qov, Ur, Ur, Ur, Qxu^Qov, Ur, Qxu^Qov, Qxu^Qov, Qxu^Qov, Qxu^Qov, Qxu^Qov, Qxu^Qov, Ur, Ur, Ur, Qxu^Qov, Qxu^Qov, Qxu^Qov, Qxu^Qov, Qxu^Qov, Qxu^Qov, Qxu^Qov, Qxu^Qov, Qxu^Qov, Qxu^Qov, Qxu^Qov
Ur, Ur^Kov, Ur^Vov, Ur^Kov, Ur^Kov, Ur, Ur, Ur, Ur, Ur, Ur, Ur, Ur, Ur, Ur, Ur, Qxu^Qov, Qxu^Qov, Qxu^Qov, Qxu^Qov, Ur, Ur, Ur, Qxu^Qov, Qxu^Qov, Qxu^Qov, Qxu^Qov, Qxu^Qov, Qxu^Qov, Qxu^Qov, Qxu^Qov, Qxu^Qov, Qxu^Qov, Ur, Qxu^Qov, Qxu^Qov, Qxu^Qov, Qxu^Qov, Qxu^Qov, Qxu^Qov, Qxu^Qov, Qxu^Qov, Qxu^Qov, Qxu^Qov, Qxu^Qov, Qxu^Qov
Ur, Ur, Ur, Ur^Vov, Ur, Ur, Ur, Ur, Ur, Ur, Ur, Ur, Ur, Ur, Qxu^Qov, Qxu^Qov, Qxu^Qov, Qxu^Qov, Ur, Ur, Ur, Ur, Qxu^Qov, Qxu^Qov, Qxu^Qov, Qxu^Qov, Qxu^Qov, Qxu^Qov, Qxu^Qov, Qxu^Qov, Qxu^Qov, Qxu^Qov, Qxu^Qov, Qxu^Qov, Qxu^Qov, Qxu^Qov, Qxu^Qov, Qxu^Qov, Qxu^Qov, Qxu^Qov, Qxu^Qov, Qxu^Qov, Qxu^Qov, Qxu^Qov, Qxu^Qov, Qxu^Qov
Ur, Ur, Ur, Ur, 1 Ur, Ur, Ur, Ur^Kov, Ur^Kov, Ur, Ur, Ur, Ur, Qxu^Qov, Ur, Qxu^Qov, Ur, Ur, Ur, Ur, Qxu^Qov, Qxu^Qov, Qxu^Qov, Qxu^Qov, Qxu^Qov, Qxu^Qov, Qxu^Qov, Qxu^Qov, Qxu^Qov, Qxu^Qov, Qxu^Qov, Qxu^Qov, Qxu^Qov, Qxu^Qov, Qxu^Qov, Qxu^Qov, Qxu^Qov, Qxu^Qov, Qxu^Qov, Qxu^Qov, Qxu^Qov, Qxu^Qov, Qxu^Qov, Qxu^Qov, Qxu^Qov, Qxu^Qov
Ur, Ur, Ur, Ur, Ur, Ur, Ur, Ur^Vov, Ur^Kov, Ur^Kov, Qxu^Qov, Ur, Qxu^Qov, Ur, Qxu^Qov, Ur, Qxu^Qov, Ur, Qxu^Qov, Qxu^Qov, Qxu^Qov, Qxu^Qov, Qxu^Qov, Qxu^Qov, Qxu^Qov, Qxu^Qov, Qxu^Qov, Qxu^Qov, Qxu^Qov, Qxu^Qov, Qxu^Qov, Qxu^Qov, Qxu^Qov, Qxu^Qov, Qxu^Qov, Qxu^Qov, Qxu^Qov, Qxu^Qov, Qxu^Qov, Qxu^Qov, Qxu^Qov, Qxu^Qov, Qxu^Qov, Qxu^Qov, Qxu^Qov, Qxu^Qov
Ur, Ur, Ur, Ur, Ur, Ur, Ur, Ur, Qxu^Qov, Qxu^Qov, Qxu^Qov, Qxu^Qov, Qxu^Qov, Qxu^Qov, Qxu^Qov, Qxu^Qov, Qxu^Qov, Qxu^Qov, Qxu^Qov, Qxu^Qov, Qxu^Qov, Qxu^Qov, Qxu^Qov, Qxu^Qov, Qxu^Qov, Qxu^Qov, Qxu^Qov, Qxu^Qov, Qxu^Qov, Qxu^Qov, Qxu^Qov, Qxu^Qov, Qxu^Qov, Qxu^Qov, Qxu^Qov, Qxu^Qov, Qxu^Qov, Qxu^Qov, Qxu^Qov, Qxu^Qov, Qxu^Qov, Qxu^Qov, Qxu^Qov, Qxu^Qov, Qxu^Qov, Qxu^Qov
Ur, Ur, Ur, Ur, Ur, Ur, Qxu^Qov, Qxu^Qov, Qxu^Qov, Qxu^Qov, Qxu^Qov, Qxu^Qov, Qxu^Qov, Qxu^Qov, Qxu^Qov, Qxu^Qov, Qxu^Qov, Qxu^Qov, Qxu^Qov, Qxu^Qov, Qxu^Qov, Qxu^Qov, Qxu^Qov, Qxu^Qov, Qxu^Qov, Qxu^Qov, Qxu^Qov, Qxu^Qov, Qxu^Qov, Qxu^Qov, Qxu^Qov, Qxu^Qov, Qxu^Qov, Qxu^Qov, Qxu^Qov, Qxu^Qov, Qxu^Qov, Qxu^Qov, Qxu^Qov, Qxu^Qov, Qxu^Qov, Qxu^Qov, Qxu^Qov, Qxu^Qov, Qxu^Qov, Qxu^Qov
