border_size=1
usage=map

Xv, Xv, Xv, Xv, Xv, Xv, Xv, Xv, Xv, Xv, Xv, Xv, Xv, Xv, Xv, Xv, Xv, Xv, Xv, Xv, Xv, Xv, Xv, Xv, Xv, Xv, Xv, Xv, Xv, Xv, Xv, Xv, Xv, Xv, Xv, Xv, Xv, Xv, Xv, Xv, Xv, Xv, Xv, Xv, Xv, Xv, Xv, Xv
Qxu^Qov, Xv, Qxu^Qov, Xv, Qxu^Qov, Xv, Qxu^Qov, Xv, Qxu^Qov, Xv, Qxu^Qov, Xv, Qxu^Qov, Xv, Qxu^Qov, Xv, Qxu^Qov, Xv, Qxu^Qov, Xv, Qxu^Qov, Xv, Qxu^Qov, Xv, Qxu^Qov, Xv, Qxu^Qov, Xv, Qxu^Qov, Xv, Qxu^Qov, Xv, Qxu^Qov, Xv, Qxu^Qov, Xv, Qxu^Qov, Xv, Qxu^Qov, Xv, Qxu^Qov, Xv, Qxu^Qov, Xv, Qxu^Qov, Xv, Qxu^Qov, Xv
Qxu^Qov, Qxu^Qov, Qxu^Qov, Qxu^Qov, Qxu^Qov, Qxu^Qov, Qxu^Qov, Qxu^Qov, Qxu^Qov, Qxu^Qov, Qxu^Qov, Qxu^Qov, Qxu^Qov, Qxu^Qov, Qxu^Qov, Qxu^Qov, Qxu^Qov, Qxu^Qov, Qxu^Qov, Qxu^Qov, Qxu^Qov, Qxu^Qov, Qxu^Qov, Qxu^Qov, Qxu^Qov, Qxu^Qov, Qxu^Qov, Qxu^Qov, Qxu^Qov, Qxu^Qov, Qxu^Qov, Qxu^Qov, Qxu^Qov, Qxu^Qov, Qxu^Qov, Qxu^Qov, Qxu^Qov, Qxu^Qov, Qxu^Qov, Qxu^Qov, Qxu^Qov, Qxu^Qov, Qxu^Qov, Qxu^Qov, Qxu^Qov, Qxu^Qov, Qxu^Qov, Qxu^Qov
Qxu^Qov, Qxu^Qov, Qxu^Qov, Qxu^Qov, Qxu^Qov, Qxu^Qov, Qxu^Qov, Qxu^Qov, Qxu^Qov, Qxu^Qov, Qxu^Qov, Qxu^Qov, Qxu^Qov, Qxu^Qov, Qxu^Qov, Qxu^Qov, Qxu^Qov, Qxu^Qov, Qxu^Qov, Qxu^Qov, Qxu^Qov, Qxu^Qov, Ur, Ur, Qxu^Qov, Qxu^Qov, Qxu^Qov, Qxu^Qov, Qxu^Qov, Qxu^Qov, Qxu^Qov, Qxu^Qov, Qxu^Qov, Qxu^Qov, Qxu^Qov, Qxu^Qov, Qxu^Qov, Qxu^Qov, Qxu^Qov, Qxu^Qov, Qxu^Qov, Qxu^Qov, Qxu^Qov, Qxu^Qov, Qxu^Qov, Qxu^Qov, Qxu^Qov, Qxu^Qov
Qxu^Qov, Qxu^Qov, Qxu^Qov, Qxu^Qov, Qxu^Qov, Qxu^Qov, Qxu^Qov, Qxu^Qov, Qxu^Qov, Qxu^Qov, Qxu^Qov, Qxu^Qov, Qxu^Qov, Qxu^Qov, Qxu^Qov, Qxu^Qov, Qxu^Qov, Qxu^Qov, Qxu^Qov, Qxu^Qov, Ur, Ur, Qxu^Qov, Qxu^Qov, Qxu^Qov, Qxu^Qov, Qxu^Qov, Qxu^Qov, Qxu^Qov, Qxu^Qov, Qxu^Qov, Qxu^Qov, Qxu^Qov, Qxu^Qov, Qxu^Qov, Qxu^Qov, Qxu^Qov, Qxu^Qov, Qxu^Qov, Qxu^Qov, Qxu^Qov, Qxu^Qov, Qxu^Qov, Qxu^Qov, Qxu^Qov, Qxu^Qov, Qxu^Qov, Qxu^Qov
Qxu^Qov, Qxu^Qov, Qxu^Qov, Qxu^Qov, Qxu^Qov, Qxu^Qov, Qxu^Qov, Qxu^Qov, Qxu^Qov, Qxu^Qov, Qxu^Qov, Qxu^Qov, Qxu^Qov, Qxu^Qov, Qxu^Qov, Qxu^Qov, Qxu^Qov, Qxu^Qov, Ur, Ur, Qxu^Qov, Qxu^Qov, Qxu^Qov, Qxu^Qov, Qxu^Qov, Qxu^Qov, Qxu^Qov, Qxu^Qov, Qxu^Qov, Qxu^Qov, Qxu^Qov, Qxu^Qov, Qxu^Xo, Qxu^Qov, Qxu^Qov, Qxu^Qov, Qxu^Qov, Qxu^Qov, Qxu^Qov, Qxu^Qov, Qxu^Qov, Qxu^Qov, Qxu^Qov, Qxu^Qov, Qxu^Qov, Qxu^Qov, Qxu^Qov, Qxu^Qov
Qxu^Qov, Qxu^Qov, Qxu^Qov, Qxu^Qov, Qxu^Qov, Qxu^Qov, Qxu^Qov, Qxu^Qov, Qxu^Qov, Qxu^Qov, Qxu^Qov, Qxu^Qov, Qxu^Qov, Qxu^Qov, Qxu^Qov, Qxu^Qov, Ur, Ur, Qxu^Qov, Qxu^Qov, Qxu^Qov, Qxu^Qov, Qxu^Qov, Qxu^Qov, Qxu^Qov, Qxu^Qov, Qxu^Qov, Qxu^Qov, Qxu^Qov, Qxu^Qov, Qxu^Qov, Qxu^Xo, Qxu^Xo, Qxu^Xo, Qxu^Qov, Qxu^Qov, Qxu^Qov, Qxu^Qov, Qxu^Qov, Qxu^Qov, Qxu^Qov, Qxu^Qov, Qxu^Qov, Qxu^Qov, Qxu^Qov, Qxu^Qov, Qxu^Qov, Qxu^Qov
Qxu^Qov, Qxu^Qov, Qxu^Qov, Qxu^Qov, Qxu^Qov, Qxu^Qov, Qxu^Qov, Qxu^Qov, Qxu^Qov, Qxu^Qov, Qxu^Qov, Qxu^Qov, Qxu^Qov, Qxu^Qov, Ur, Ur, Qxu^Qov, Qxu^Qov, Qxu^Qov, Qxu^Qov, Qxu^Qov, Qxu^Qov, Qxu^Qov, Qxu^Qov, Qxu^Qov, Qxu^Qov, Qxu^Qov, Qxu^Qov, Qxu^Qov, Qxu^Qov, Qxu^Qov, Qxu^Xo, Qxu^Xo, Qxu^Xo, Qxu^Qov, Qxu^Qov, Qxu^Qov, Qxu^Qov, Qxu^Qov, Qxu^Qov, Qxu^Qov, Qxu^Qov, Qxu^Qov, Qxu^Qov, Qxu^Qov, Qxu^Qov, Qxu^Qov, Qxu^Qov
Qxu^Qov, Qxu^Qov, Qxu^Qov, Qxu^Qov, Qxu^Qov, Qxu^Qov, Qxu^Qov, Qxu^Qov, Qxu^Qov, Qxu^Qov, Qxu^Qov, Qxu^Qov, Ur, Ur, Qxu^Qov, Qxu^Qov, Qxu^Qov, Qxu^Qov, Qxu^Qov, Qxu^Qov, Qxu^Qov, Qxu^Qov, Qxu^Qov, Qxu^Qov, Qxu^Qov, Qxu^Qov, Qxu^Qov, Qxu^Qov, Qxu^Qov, Qxu^Qov, Qxu^Qov, Qxu^Qov, Qxu^Qov, Qxu^Qov, Qxu^Qov, Qxu^Qov, Qxu^Qov, Qxu^Qov, Qxu^Qov, Qxu^Qov, Qxu^Qov, Qxu^Qov, Qxu^Qov, Qxu^Qov, Qxu^Qov, Qxu^Qov, Qxu^Qov, Qxu^Qov
Qxu^Qov, Qxu^Qov, Qxu^Qov, Qxu^Qov, Qxu^Qov, Qxu^Qov, Qxu^Qov, Qxu^Qov, Qxu^Qov, Qxu^Qov, Ur, Ur, Qxu^Qov, Qxu^Qov, Qxu^Qov, Qxu^Qov, Qxu^Qov, Qxu^Qov, Qxu^Qov, Qxu^Qov, Qxu^Qov, Qxu^Qov, Qxu^Qov, Qxu^Qov, Qxu^Qov, Qxu^Qov, Qxu^Qov, Qxu^Qov, Qxu^Qov, Qxu^Qov, Qxu^Qov, Qxu^Qov, Qxu^Qov, Qxu^Qov, Qxu^Qov, Qxu^Qov, Qxu^Qov, Qxu^Qov, Qxu^Qov, Qxu^Qov, Qxu^Qov, Qxu^Qov, Qxu^Qov, Qxu^Qov, Qxu^Qov, Qxu^Qov, Qxu^Qov, Qxu^Qov
Qxu^Qov, Qxu^Qov, Qxu^Qov, Qxu^Qov, Qxu^Qov, Qxu^Qov, Qxu^Qov, Qxu^Qov, Qxu^Qov, Ur, Qxu^Qov, Qxu^Qov, Qxu^Qov, Qxu^Qov, Qxu^Qov, Qxu^Qov, Qxu^Qov, Qxu^Qov, Qxu^Qov, Qxu^Qov, Qxu^Qov, Qxu^Qov, Qxu^Qov, Qxu^Qov, Qxu^Qov, Qxu^Qov, Qxu^Qov, Qxu^Qov, Qxu^Qov, Qxu^Qov, Qxu^Qov, Qxu^Qov, Qxu^Qov, Qxu^Qov, Qxu^Qov, Qxu^Qov, Qxu^Qov, Qxu^Qov, Qxu^Qov, Qxu^Qov, Qxu^Qov, Qxu^Qov, Qxu^Qov, Qxu^Qov, Qxu^Qov, Qxu^Qov, Qxu^Qov, Qxu^Qov
Qxu^Qov, Qxu^Qov, Qxu^Qov, Qxu^Qov, Qxu^Qov, Qxu^Qov, Qxu^Qov, Qxu^Qov, Ur, Ur, Qxu^Qov, Qxu^Qov, Qxu^Qov, Qxu^Qov, Qxu^Qov, Qxu^Qov, Qxu^Qov, Qxu^Qov, Qxu^Qov, Qxu^Qov, Qxu^Qov, Qxu^Qov, Qxu^Qov, Qxu^Qov, Qxu^Qov, Qxu^Qov, Qxu^Qov, Qxu^Qov, Qxu^Qov, Qxu^Qov, Qxu^Qov, Qxu^Qov, Qxu^Qov, Qxu^Qov, Qxu^Qov, Qxu^Qov, Qxu^Qov, Qxu^Qov, Qxu^Qov, Qxu^Qov, Qxu^Qov, Qxu^Qov, Qxu^Qov, Qxu^Qov, Qxu^Qov, Qxu^Qov, Qxu^Qov, Qxu^Qov
Qxu^Qov, Qxu^Qov, Qxu^Qov, Qxu^Qov, Qxu^Qov, Qxu^Qov, Qxu^Qov, Ur, Ur, Qxu^Qov, Qxu^Qov, Qxu^Qov, Qxu^Qov, Qxu^Qov, Qxu^Qov, Qxu^Qov, Qxu^Qov, Qxu^Qov, Qxu^Qov, Qxu^Qov, Qxu^Qov, Qxu^Qov, Qxu^Qov, Qxu^Qov, Qxu^Qov, Qxu^Qov, Qxu^Qov, Qxu^Qov, Qxu^Qov, Qxu^Qov, Qxu^Qov, Qxu^Qov, Qxu^Qov, Qxu^Qov, Qxu^Qov, Qxu^Qov, Qxu^Qov, Qxu^Qov, Qxu^Qov, Qxu^Qov, Qxu^Xo, Qxu^Qov, Qxu^Qov, Qxu^Qov, Qxu^Qov, Qxu^Qov, Qxu^Qov, Qxu^Qov
Qxu^Qov, Qxu^Qov, Qxu^Qov, Qxu^Qov, Qxu^Qov, Qxu^Qov, Ur, Ur, Qxu^Qov, Qxu^Qov, Qxu^Qov, Qxu^Qov, Qxu^Qov, Qxu^Qov, Qxu^Qov, Qxu^Qov, Qxu^Qov, Qxu^Qov, Qxu^Qov, Qxu^Qov, Qxu^Qov, Qxu^Qov, Qxu^Qov, Qxu^Qov, Qxu^Qov, Qxu^Qov, Qxu^Qov, Qxu^Qov, Qxu^Qov, Qxu^Qov, Qxu^Qov, Qxu^Qov, Qxu^Qov, Qxu^Qov, Qxu^Qov, Qxu^Qov, Qxu^Qov, Qxu^Qov, Qxu^Xo, Qxu^Xo, Qxu^Qov, Qxu^Xo, Qxu^Qov, Qxu^Qov, Qxu^Qov, Qxu^Qov, Qxu^Qov, Qxu^Qov
Qxu^Qov, Qxu^Qov, Qxu^Qov, Qxu^Qov, Qxu^Qov, Qxu^Qov, Ur, Qxu^Qov, Qxu^Qov, Qxu^Qov, Qxu^Qov, Qxu^Qov, Qxu^Qov, Qxu^Qov, Qxu^Qov, Qxu^Qov, Qxu^Qov, Qxu^Qov, Qxu^Qov, Qxu^Qov, Qxu^Qov, Qxu^Qov, Qxu^Qov, Qxu^Qov, Qxu^Qov, Qxu^Qov, Qxu^Qov, Qxu^Qov, Qxu^Qov, Qxu^Qov, Qxu^Qov, Qxu^Qov, Qxu^Qov, Qxu^Qov, Qxu^Qov, Qxu^Qov, Qxu^Qov, Qxu^Qov, Qxu^Xo, Qxu^Qov, Qxu^Qov, Qxu^Xo, Qxu^Qov, Qxu^Qov, Qxu^Qov, Qxu^Qov, Qxu^Qov, Qxu^Qov
Qxu^Qov, Qxu^Qov, Qxu^Qov, Qxu^Qov, Qxu^Qov, Qxu^Qov, Ur, Ur, Ur, Qxu^Qov, Qxu^Qov, Qxu^Qov, Qxu^Qov, Qxu^Qov, Qxu^Qov, Qxu^Qov, Qxu^Qov, Qxu^Qov, Qxu^Qov, Qxu^Qov, Qxu^Qov, Qxu^Qov, Qxu^Qov, Qxu^Qov, Qxu^Qov, Qxu^Qov, Qxu^Qov, Qxu^Qov, Qxu^Qov, Qxu^Qov, Qxu^Qov, Qxu^Qov, Qxu^Qov, Qxu^Qov, Qxu^Qov, Qxu^Qov, Qxu^Qov, Qxu^Qov, Qxu^Qov, Qxu^Xo, Qxu^Xo, Qxu^Xo, Qxu^Qov, Qxu^Qov, Qxu^Qov, Qxu^Qov, Qxu^Qov, Qxu^Qov
Qxu^Qov, Qxu^Qov, Qxu^Qov, Qxu^Qov, Qxu^Qov, Qxu^Qov, Qxu^Qov, Ur, Ur, Qxu^Qov, Qxu^Qov, Qxu^Qov, Qxu^Qov, Qxu^Qov, Qxu^Qov, Qxu^Qov, Qxu^Qov, Qxu^Qov, Qxu^Qov, Qxu^Qov, Qxu^Qov, Qxu^Qov, Qxu^Qov, Qxu^Qov, Qxu^Qov, Qxu^Qov, Qxu^Qov, Qxu^Qov, Qxu^Qov, Qxu^Qov, Qxu^Qov, Qxu^Qov, Qxu^Qov, Qxu^Qov, Qxu^Qov, Qxu^Qov, Qxu^Qov, Qxu^Qov, Qxu^Qov, Qxu^Qov, Qxu^Qov, Qxu^Qov, Qxu^Qov, Qxu^Qov, Qxu^Qov, Qxu^Qov, Qxu^Qov, Qxu^Qov
Qxu^Qov, Qxu^Qov, Qxu^Qov, Qxu^Qov, Qxu^Qov, Qxu^Qov, Qxu^Qov, Ur, Ur, Ur, Ur, Qxu^Qov, Qxu^Qov, Qxu^Qov, Qxu^Qov, Qxu^Qov, Qxu^Qov, Qxu^Qov, Qxu^Qov, Qxu^Qov, Qxu^Qov, Qxu^Qov, Qxu^Qov, Qxu^Qov, Qxu^Qov, Qxu^Qov, Qxy, Qxy, Ur, Qxu^Qov, Qxu^Qov, Qxu^Qov, Qxu^Qov, Qxu^Qov, Qxu^Qov, Qxu^Qov, Qxu^Qov, Qxu^Qov, Qxu^Qov, Qxu^Qov, Qxu^Qov, Qxu^Qov, Qxu^Qov, Qxu^Qov, Qxu^Qov, Qxu^Qov, Qxu^Qov, Qxu^Qov
Qxu^Qov, Qxu^Qov, Qxu^Qov, Qxu^Qov, Qxu^Qov, Qxu^Qov, Qxu^Qov, Qxu^Qov, Ur, Ur, Ur, Ur, Ur, Qxu^Qov, Qxu^Qov, Qxu^Qov, Qxu^Qov, Qxu^Qov, Qxu^Qov, Qxu^Qov, Qxu^Qov, Qxu^Qov, Qxu^Qov, Qxu^Qov, Ur^Cov, Ur^Cov, Ur, Ur, Ur, Ur, Ur, Qxu^Qov, Qxu^Qov, Qxu^Qov, Qxu^Qov, Qxu^Qov, Qxu^Qov, Qxu^Qov, Qxu^Qov, Qxu^Qov, Qxu^Qov, Qxu^Qov, Qxu^Qov, Qxu^Qov, Qxu^Qov, Qxu^Qov, Qxu^Qov, Qxu^Qov
Qxu^Qov, Qxu^Qov, Qxu^Qov, Qxu^Qov, Qxu^Qov, Qxu^Qov, Qxu^Qov, Qxu^Qov, Qxu^Qov, Ur, Ur, Ur, Qxu^Qov, Qxu^Qov, Qxu^Qov, Qxu^Qov, Qxu^Qov, Qxu^Qov, Qxu^Qov, Qxu^Qov, Qxu^Qov, Qxu^Qov, Qxy, Qxy, Ur^Cov, Ur^Cov, Ur^Kov, Ur, 2 Ur, Ur, Ur, Ur, Ur, Qxu^Qov, Qxu^Qov, Qxu^Qov, Qxu^Qov, Qxu^Qov, Qxu^Qov, Qxu^Qov, Qxu^Qov, Qxu^Qov, Qxu^Qov, Qxu^Qov, Qxu^Qov, Qxu^Qov, Qxu^Qov, Qxu^Qov
Qxu^Qov, Qxu^Qov, Qxu^Qov, Qxu^Qov, Qxu^Qov, Qxu^Qov, Qxu^Qov, Qxu^Qov, Qxu^Qov, Qxu^Qov, Qxu^Qov, Qxu^Qov, Qxu^Qov, Qxu^Qov, Qxu^Qov, Qxu^Qov, Qxu^Qov, Qxu^Qov, Qxu^Qov, Qxu^Qov, Ur^Cov, Qxy, Ur, Ur^Cov, Ur, Ur, Ur, Ur, Ur, Ur, Ur, Ur, Ur, Ur, Ur, Qxu^Qov, Qxu^Qov, Qxu^Qov, Qxu^Qov, Qxu^Qov, Qxu^Qov, Qxu^Qov, Qxu^Qov, Qxu^Qov, Qxu^Qov, Qxu^Qov, Qxu^Qov, Qxu^Qov
Qxu^Qov, Qxu^Qov, Qxu^Qov, Qxu^Qov, Qxu^Qov, Qxu^Qov, Qxu^Qov, Qxu^Qov, Qxu^Qov, Qxu^Qov, Qxu^Qov, Qxu^Qov, Qxu^Qov, Qxu^Qov, Qxu^Qov, Qxu^Qov, Qxu^Qov, Qxu^Qov, Qxy^Vud, Qxy, Ur, Ur, Ur, Ur, Ur, Ur, Ur, Ur, Ur, Ur^Kov, Ur^Cov, Ur, Ur^Cov, Ur, Qxu^Qov, Qxu^Qov, Qxu^Qov, Qxu^Qov, Qxu^Qov, Qxu^Qov, Qxu^Qov, Qxu^Qov, Qxu^Qov, Qxu^Qov, Qxu^Qov, Qxu^Qov, Qxu^Qov, Qxu^Qov
Qxu^Qov, Qxu^Qov, Qxu^Qov, Qxu^Qov, Qxu^Qov, Qxu^Qov, Qxu^Qov, Qxu^Qov, Qxu^Qov, Qxu^Qov, Qxu^Qov, Qxu^Qov, Qxu^Qov, Qxu^Qov, Qxu^Qov, Qxu^Qov, Qxy, Qxy, Ur, Ur, Ur, Ur, Ur, Ur, Ur, Ur, Ur, Ur, Ur^Cov, Ur^Cov, Ur, Ur^Cov, Qxu^Qov, Qxu^Qov, Qxu^Qov, Qxu^Qov, Qxu^Qov, Qxu^Qov, Qxu^Qov, Qxu^Qov, Qxu^Qov, Qxu^Qov, Qxu^Qov, Qxu^Qov, Qxu^Qov, Qxu^Qov, Qxu^Qov, Qxu^Qov
Qxu^Qov, Qxu^Qov, Qxu^Qov, Qxu^Qov, Qxu^Qov, Qxu^Qov, Qxu^Qov, Qxu^Qov, Qxu^Qov, Qxu^Qov, Qxu^Qov, Qxu^Qov, Qxu^Qov, Qxu^Qov, Qxy, Ur^Cov, Ur, Ur, Ur, Ur, Ur, Ur, Ur, Ur, Ur, Ur, Ur, Ur, Ur, Ur, Qxu^Qov, Qxu^Qov, Qxu^Qov, Qxu^Qov, Qxu^Qov, Qxu^Qov, Qxu^Qov, Qxu^Qov, Qxu^Qov, Qxu^Qov, Qxu^Qov, Qxu^Qov, Qxu^Qov, Qxu^Qov, Qxu^Qov, Qxu^Qov, Qxu^Qov, Qxu^Qov
Qxu^Qov, Qxu^Qov, Qxu^Qov, Qxu^Qov, Qxu^Qov, Qxu^Qov, Qxu^Qov, Qxu^Qov, Qxu^Qov, Qxu^Qov, Qxu^Qov, Qxu^Qov, Qxy, Qxy^Vud, Ur, Ur, Ur, Ur, Ur, Ur, Ur, Ur, Ur, Ur, Ur, Ur, Ur, Ur^Cov, Qxu^Qov, Qxu^Qov, Qxu^Qov, Qxu^Qov, Qxu^Qov, Qxu^Qov, Qxu^Qov, Qxu^Qov, Qxu^Qov, Qxu^Qov, Qxu^Qov, Qxu^Qov, Qxu^Qov, Qxu^Qov, Qxu^Qov, Qxu^Qov, Qxu^Qov, Qxu^Qov, Qxu^Qov, Qxu^Qov
Qxu^Qov, Qxu^Qov, Qxu^Qov, Qxu^Qov, Qxu^Qov, Qxu^Qov, Qxu^Qov, Qxu^Qov, Qxu^Qov, Qxu^Qov, Qxy^Vud, Qxy, Ur, Ur, Ur, Ur, Ur, Ur, Ur, Ur, Ur, Ur, Ur, Ur, Ur, Qxy^Vud, Qxu^Qov, Qxu^Qov, Qxu^Qov, Qxu^Qov, Qxu^Qov, Qxu^Qov, Qxu^Qov, Qxu^Qov, Qxu^Qov, Qxu^Qov, Qxu^Qov, Qxu^Qov, Qxu^Qov, Qxu^Qov, Qxu^Qov, Qxu^Qov, Qxu^Qov, Qxu^Qov, Qxu^Qov, Qxu^Qov, Qxu^Qov, Qxu^Qov
Qxu^Qov, Qxu^Qov, Qxu^Qov, Qxu^Qov, Qxu^Qov, Qxu^Qov, Qxu^Qov, Qxu^Qov, Qxy, Qxy, Ur, Ur, Ur, Ur, Ur, Ur, Ur, Ur, Ur, Ur, Ur, Ur, Ur^Cov, Ur, Qxu^Qov, Qxu^Qov, Qxu^Qov, Qxu^Qov, Qxu^Qov, Qxu^Qov, Qxu^Qov, Qxu^Qov, Qxu^Qov, Qxu^Qov, Qxu^Qov, Qxu^Qov, Qxu^Qov, Qxu^Qov, Qxu^Qov, Qxu^Qov, Qxu^Qov, Qxu^Qov, Qxu^Qov, Qxu^Qov, Qxu^Qov, Qxu^Qov, Qxu^Qov, Qxu^Qov
Qxu^Qov, Qxu^Qov, Qxu^Qov, Qxu^Qov, Qxu^Qov, Qxu^Qov, Qxy, Qxy, Ur, Ur, Ur, Ur, Ur, Ur, Ur, Ur, Ur, Ur, Ur, Ur, Ur^Vud, Ur, Qxu^Qov, Qxu^Qov, Qxu^Qov, Qxu^Qov, Qxu^Qov, Qxu^Qov, Qxu^Qov, Qxu^Qov, Qxu^Qov, Qxu^Qov, Qxu^Qov, Qxu^Qov, Qxu^Qov, Qxu^Qov, Qxu^Qov, Qxu^Qov, Qxu^Qov, Qxu^Qov, Qxu^Qov, Qxu^Qov, Qxu^Qov, Qxu^Qov, Qxu^Qov, Qxu^Qov, Qxu^Qov, Qxu^Qov
Qxu^Qov, Qxu^Qov, Qxu^Qov, Qxu^Qov, Uu^Vud, Qxy, Ur, Ur, Ur, Ur, Ur, Ur, Ur, Ur, Ur, Ur, Ur, Ur, Ur, Ur, Qxu^Qov, Qxu^Qov, Qxu^Qov, Qxu^Qov, Qxu^Qov, Qxu^Qov, Qxu^Qov, Qxu^Qov, Qxu^Qov, Qxu^Qov, Qxu^Qov, Qxu^Qov, Qxu^Qov, Qxu^Qov, Qxu^Qov, Qxu^Qov, Qxu^Qov, Qxu^Qov, Qxu^Qov, Qxu^Qov, Qxu^Qov, Qxu^Qov, Qxu^Qov, Qxu^Qov, Qxu^Qov, Qxu^Qov, Qxu^Qov, Qxu^Qov
Qxu^Qov, Qxu^Qov, Ur^Cov, Qxy, Ur, Ur, Ur, Ur, Ur, Ur, Ur, Ur, Ur, Ur, Ur, Ur, Ur, Ur^Vud, Qxu^Qov, Qxu^Qov, Qxu^Qov, Qxu^Qov, Qxu^Qov, Qxu^Qov, Qxu^Qov, Qxu^Qov, Qxu^Qov, Qxu^Qov, Qxu^Qov, Qxu^Qov, Qxu^Qov, Qxu^Qov, Qxu^Qov, Qxu^Qov, Qxu^Qov, Qxu^Qov, Qxu^Qov, Qxu^Qov, Qxu^Qov, Qxu^Qov, Qxu^Qov, Qxu^Qov, Qxu^Qov, Qxu^Qov, Qxu^Qov, Qxu^Qov, Qxu^Qov, Qxu^Qov
Ur, Ur^Cov, Uu^Vud, Ur^Cov, Ur^Kov, Ur, Ur, Ur, Ur, Ur, Ur, Ur, Ur, Ur, Ur, Ur, Qxu^Qov, Qxu^Qov, Qxu^Qov, Qxu^Qov, Qxu^Qov, Qxu^Qov, Qxu^Qov, Qxu^Qov, Qxu^Qov, Qxu^Qov, Qxu^Qov, Qxu^Qov, Qxu^Qov, Qxu^Qov, Qxu^Qov, Qxu^Qov, Qxu^Qov, Qxu^Qov, Qxu^Qov, Qxu^Qov, Qxu^Qov, Qxu^Qov, Qxu^Qov, Qxu^Qov, Qxu^Qov, Qxu^Qov, Qxu^Qov, Qxu^Qov, Qxu^Qov, Qxu^Qov, Qxu^Qov, Qxu^Qov
Ur, Ur, Ur, Ur, Ur, Ur, Ur, Ur, Ur, Ur, Ur, Ur, Ur, Ur, Qxu^Qov, Qxu^Qov, Qxu^Qov, Qxu^Qov, Qxu^Qov, Qxu^Qov, Qxu^Qov, Qxu^Qov, Qxu^Qov, Qxu^Qov, Qxu^Qov, Qxu^Qov, Qxu^Qov, Qxu^Qov, Qxu^Qov, Qxu^Qov, Qxu^Qov, Qxu^Qov, Qxu^Qov, Qxu^Qov, Qxu^Qov, Qxu^Qov, Qxu^Qov, Qxu^Qov, Qxu^Qov, Qxu^Qov, Qxu^Qov, Qxu^Qov, Qxu^Qov, Qxu^Qov, Qxu^Qov, Qxu^Qov, Qxu^Qov, Qxu^Qov
Ur, Ur, Ur, Ur, 1 Ur, Ur, Ur, Ur^Kov, Ur^Cov, Ur, Ur, Uu^Vud, Qxu^Qov, Qxu^Qov, Qxu^Qov, Qxu^Qov, Qxu^Qov, Qxu^Qov, Qxu^Qov, Qxu^Qov, Qxu^Qov, Qxu^Qov, Qxu^Qov, Qxu^Qov, Qxu^Qov, Qxu^Qov, Qxu^Qov, Qxu^Qov, Qxu^Qov, Qxu^Qov, Qxu^Qov, Qxu^Qov, Qxu^Qov, Qxu^Qov, Qxu^Qov, Qxu^Qov, Qxu^Qov, Qxu^Qov, Qxu^Qov, Qxu^Qov, Qxu^Qov, Qxu^Qov, Qxu^Qov, Qxu^Qov, Qxu^Qov, Qxu^Qov, Qxu^Qov, Qxu^Qov
Ur, Ur, Ur, Ur, Ur, Ur, Ur, Uu^Vud, Ur^Cov, Ur^Cov, Qxu^Qov, Qxu^Qov, Qxu^Qov, Qxu^Qov, Qxu^Qov, Qxu^Qov, Qxu^Qov, Qxu^Qov, Qxu^Qov, Qxu^Qov, Qxu^Qov, Qxu^Qov, Qxu^Qov, Qxu^Qov, Qxu^Qov, Qxu^Qov, Qxu^Qov, Qxu^Qov, Qxu^Qov, Qxu^Qov, Qxu^Qov, Qxu^Qov, Qxu^Qov, Qxu^Qov, Qxu^Qov, Qxu^Qov, Qxu^Qov, Qxu^Qov, Qxu^Qov, Qxu^Qov, Qxu^Qov, Qxu^Qov, Qxu^Qov, Qxu^Qov, Qxu^Qov, Qxu^Qov, Qxu^Qov, Qxu^Qov
Ur, Ur, Ur, Ur, Ur, Ur, Ur, Ur, Qxu^Qov, Qxu^Qov, Qxu^Qov, Qxu^Qov, Qxu^Qov, Qxu^Qov, Qxu^Qov, Qxu^Qov, Qxu^Qov, Qxu^Qov, Qxu^Qov, Qxu^Qov, Qxu^Qov, Qxu^Qov, Qxu^Qov, Qxu^Qov, Qxu^Qov, Qxu^Qov, Qxu^Qov, Qxu^Qov, Qxu^Qov, Qxu^Qov, Qxu^Qov, Qxu^Qov, Qxu^Qov, Qxu^Qov, Qxu^Qov, Qxu^Qov, Qxu^Qov, Qxu^Qov, Qxu^Qov, Qxu^Qov, Qxu^Qov, Qxu^Qov, Qxu^Qov, Qxu^Qov, Qxu^Qov, Qxu^Qov, Qxu^Qov, Qxu^Qov
Ur, Ur, Ur, Ur, Ur, Ur, Qxu^Qov, Qxu^Qov, Qxu^Qov, Qxu^Qov, Qxu^Qov, Qxu^Qov, Qxu^Qov, Qxu^Qov, Qxu^Qov, Qxu^Qov, Qxu^Qov, Qxu^Qov, Qxu^Qov, Qxu^Qov, Qxu^Qov, Qxu^Qov, Qxu^Qov, Qxu^Qov, Qxu^Qov, Qxu^Qov, Qxu^Qov, Qxu^Qov, Qxu^Qov, Qxu^Qov, Qxu^Qov, Qxu^Qov, Qxu^Qov, Qxu^Qov, Qxu^Qov, Qxu^Qov, Qxu^Qov, Qxu^Qov, Qxu^Qov, Qxu^Qov, Qxu^Qov, Qxu^Qov, Qxu^Qov, Qxu^Qov, Qxu^Qov, Qxu^Qov, Qxu^Qov, Qxu^Qov
