border_size=1
usage=map

Urb^Qov, Urb^Qov, Urb^Qov, Urb^Qov, Urb^Qov, Urb^Qov, Urb^Qov, Urb^Qov, Urb^Qov, Urb^Qov, Urb^Qov, Urb^Qov, Urb^Qov, Urb^Qov, Urb^Qov, Urb^Qov, Urb^Qov, Urb^Qov, Urb^Qov, Urb^Qov, Urb^Qov, Urb^Qov, Urb^Qov, Urb^Qov, Urb^Qov, Urb^Qov, Urb^Qov, Urb^Qov, Urb^Qov, Urb^Qov, Urb^Qov, Urb^Qov, Urb^Qov, Urb^Qov, Urb^Qov, Urb^Qov, Urb^Qov, Urb^Qov
Urb^Qov, Urb^Qov, Urb^Qov, Urb^Qov, Urb^Qov, Urb^Qov, Urb^Qov, Urb^Qov, Urb^Qov, Urb^Qov, Urb^Qov, Urb^Qov, Urb^Qov, Urb^Qov, Urb^Qov, Urb^Qov, Urb^Qov, Urb^Qov, Urb^Qov, Urb^Qov, Urb^Qov, Urb^Qov, Urb^Qov, Urb^Qov, Urb^Qov, Urb^Qov, Urb^Qov, Urb^Qov, Urb^Qov, Urb^Qov, Urb^Qov, Urb^Qov, Urb^Qov, Urb^Qov, Urb^Qov, Urb^Qov, Urb^Qov, Urb^Qov
Urb^Qov, Urb^Qov, Urb^Qov, Urb^Qov, Urb^Qov, Urb^Qov, Urb^Qov, Urb^Qov, Urb^Qov, Urb^Qov, Urb^Qov, Urb^Qov, Urb^Qov, Urb^Qov, Urb^Qov, Urb^Qov, Urb^Qov, Urb^Qov, Urb^Qov, Urb^Qov, Urb^Qov, Urb^Qov, Urb^Qov, Urb^Qov, Urb^Qov, Urb^Qov, Urb^Qov, Urb^Qov, Urb^Qov, Urb^Qov, Urb^Qov, Urb^Qov, Urb^Qov, Urb^Qov, Urb^Qov, Urb^Qov, Urb^Qov, Urb^Qov
Urb^Qov, Urb^Qov, Urb^Qov, Urb^Qov, Urb^Qov, Urb^Qov, Urb^Qov, Urb^Qov, Urb^Qov, Urb^Qov, Urb^Qov, Urb^Qov, Urb^Qov, Urb^Qov, Urb^Qov, Urb^Qov, Urb^Qov, Urb^Qov, Urb^Qov, Urb^Qov, Urb^Qov, Urb^Qov, Urb^Qov, Urb^Qov, Urb^Qov, Urb^Qov, Urb^Qov, Urb^Qov, Urb^Qov, Urb^Qov, Urb^Qov, Urb^Qov, Urb^Qov, Urb^Qov, Urb^Qov, Urb^Qov, Urb^Qov, Urb^Qov
Urb^Qov, Urb^Qov, Urb^Qov, Urb^Qov, Urb^Qov, Urb^Qov, Urb^Qov, Urb^Qov, Urb^Qov, Urb^Qov, Urb^Qov, Urb^Qov, Urb^Qov, Urb^Qov, Urb^Qov, Urb^Qov, Urb^Qov, Urb^Qov, Urb^Qov, Urb^Qov, Urb^Qov, Urb^Qov, Urb^Qov, Urb^Qov, Urb^Qov, Urb^Qov, Urb^Qov, Urb^Qov, Urb^Qov, Urb^Qov, Urb^Qov, Urb^Qov, Urb^Qov, Urb^Qov, Urb^Qov, Urb^Qov, Urb^Qov, Urb^Qov
Urb^Qov, Urb^Qov, Urb^Qov, Urb^Qov, Urb^Qov, Urb^Qov, Urb^Qov, Urb^Qov, Urb^Qov, Urb^Qov, Urb^Qov, Urb^Qov, Urb^Qov, Urb^Qov, Urb^Qov, Urb^Qov, Urb^Qov, Urb^Qov, Urb^Qov, Urb^Qov, Urb^Qov, Urb^Qov, Urb^Qov, Urb^Qov, Urb^Qov, Urb^Qov, Urb^Qov, Urb^Qov, Urb^Qov, Urb^Qov, Urb^Qov, Urb^Qov, Urb^Qov, Urb^Qov, Urb^Qov, Urb^Qov, Urb^Qov, Urb^Qov
Urb^Qov, Urb^Qov, Urb^Qov, Urb^Qov, Urb^Qov, Urb^Qov, Urb^Qov, Urb^Qov, Urb^Qov, Urb^Qov, Urb^Qov, Urb^Qov, Urb^Qov, Urb^Qov, Urb^Qov, Urb^Qov, Urb^Qov, Urb^Qov, Urb^Qov, Urb^Qov, Urb^Qov, Urb^Qov, Urb^Qov, Urb^Qov, Urb^Qov, Urb^Qov, Urb^Qov, Urb^Qov, Urb^Qov, Urb^Qov, Urb^Qov, Urb^Qov, Urb^Qov, Urb^Qov, Urb^Qov, Urb^Qov, Urb^Qov, Urb^Qov
Urb^Qov, Urb^Qov, Urb^Qov, Urb^Qov, Urb^Qov, Urb^Qov, Urb^Qov, Urb^Qov, Urb^Qov, Urb^Qov, Urb^Qov, Urb^Qov, Urb^Qov, Urb^Qov, Urb^Qov, Urb^Qov, Urb^Qov, Urb^Qov, Urb^Qov, Urb^Qov, Urb^Qov, Urb^Qov, Urb^Qov, Urb^Qov, Urb^Qov, Urb^Qov, Urb^Qov, Urb^Qov, Urb^Qov, Urb^Qov, Urb^Qov, Urb^Qov, Urb^Qov, Urb^Qov, Urb^Qov, Urb^Qov, Urb^Qov, Urb^Qov
Urb^Qov, Urb^Qov, Urb^Qov, Urb^Qov, Urb^Qov, Urb^Qov, Urb^Qov, Urb^Qov, Urb^Qov, Urb^Qov, Urb^Qov, Urb^Qov, Urb^Qov, Urb^Qov, Urb^Qov, Urb^Qov, Urb^Qov, Urb^Qov, Urb, Urb^Qov, Urb, Urb^Qov, Urb^Qov, Urb^Qov, Urb^Qov, Urb^Qov, Urb^Qov, Urb^Qov, Urb^Qov, Urb^Qov, Urb^Qov, Urb^Qov, Urb^Qov, Urb^Qov, Urb^Qov, Urb^Qov, Urb^Qov, Urb^Qov
Urb^Qov, Urb^Qov, Urb^Qov, Urb^Qov, Urb^Qov, Urb^Qov, Urb^Qov, Urb^Qov, Urb^Qov, Urb^Qov, Urb^Qov, Urb^Qov, Urb^Qov, Urb^Qov, Urb, Urb^Qov, Urb, Urb, Urb, Urb, Urb, Urb, Urb, Urb, Urb, Urb^Qov, Urb, Urb^Qov, Urb^Qov, Urb^Qov, Urb^Qov, Urb^Qov, Urb^Qov, Urb^Qov, Urb^Qov, Urb^Qov, Urb^Qov, Urb^Qov
Urb^Qov, Urb^Qov, Urb^Qov, Urb^Qov, Urb^Qov, Urb^Qov, Urb^Qov, Urb^Qov, Urb^Qov, Urb^Qov, Urb, Urb, Urb, Urb, Urb, Urb, Urb, Urb, Urb, Urb, Urb, Urb, Urb, Urb, Urb, Urb, Urb, Urb, Urb, Urb^Qov, Urb^Qov, Urb^Qov, Urb^Qov, Urb^Qov, Urb^Qov, Urb^Qov, Urb^Qov, Urb^Qov
Urb^Qov, Urb^Qov, Urb^Qov, Urb^Qov, Urb^Qov, Urb^Qov, Urb^Qov, Urb^Qov, Urb, Urb, Urb, Urb, Urb, Urb, Urb, 2 Urb, Urb, Urb, Urb, Urb, Urb, Urb, Urb, Urb, Urb, Urb, Urb, Urb, Urb, Urb, Urb, Urb^Qov, Urb^Qov, Urb^Qov, Urb^Qov, Urb^Qov, Urb^Qov, Urb^Qov
Urb^Qov, Urb^Qov, Urb^Qov, Urb^Qov, Urb^Qov, Urb^Qov, Urb^Qov, Urb^Qov, Urb, Urb, Urb, Urb, Urb, Urb, Urb, Urb, Urb, Urb, Urb, Urb, Urb, Urb, Urb, Urb, Urb, Urb, Urb, Urb, Urb, Urb, Urb, Urb^Qov, Urb^Qov, Urb^Qov, Urb^Qov, Urb^Qov, Urb^Qov, Urb^Qov
Urb^Qov, Urb^Qov, Urb^Qov, Urb^Qov, Urb^Qov, Urb^Qov, Urb^Qov, Urb, Urb, Urb, Urb, Urb, Urb, Urb, Urb, Urb, Urb, Urb, Urb, Urb, 3 Urb, Urb, Urb, Urb, Urb, Urb, Urb, Urb, Urb, Urb, Urb, Urb, Urb^Qov, Urb^Qov, Urb^Qov, Urb^Qov, Urb^Qov, Urb^Qov
Urb^Qov, Urb^Qov, Urb^Qov, Urb^Qov, Urb^Qov, Urb^Qov, Urb^Qov, Urb, Urb, Urb, Urb, Urb, Urb, Urb, Urb, Urb, Urb, Urb, Urb, Urb, Urb, Urb, Urb, Urb, Urb, Urb, Urb, Urb, Urb, Urb, Urb, Urb, Urb^Qov, Urb^Qov, Urb^Qov, Urb^Qov, Urb^Qov, Urb^Qov
Urb^Qov, Urb^Qov, Urb^Qov, Urb^Qov, Urb^Qov, Urb^Qov, Urb^Qov, Urb, Urb, Urb, Urb, Urb, Urb, Urb, Urb, Urb, Urb, Urb, Urb, Urb, Urb, Urb, Urb, Urb, 1 Urb, Urb, Urb, Urb, Urb, Urb, Urb, Urb^Qov, Urb^Qov, Urb^Qov, Urb^Qov, Urb^Qov, Urb^Qov, Urb^Qov
Urb^Qov, Urb^Qov, Urb^Qov, Urb^Qov, Urb^Qov, Urb^Qov, Urb^Qov, Urb^Qov, Urb^Qov, Urb, Urb, Urb, Urb, Urb, Urb, Urb, Urb, Urb, Urb, Urb, Urb, Urb, Urb, Urb, Urb, Urb, Urb, Urb, Urb, Urb, Urb^Qov, Urb^Qov, Urb^Qov, Urb^Qov, Urb^Qov, Urb^Qov, Urb^Qov, Urb^Qov
Urb^Qov, Urb^Qov, Urb^Qov, Urb^Qov, Urb^Qov, Urb^Qov, Urb^Qov, Urb^Qov, Urb^Qov, Urb, Urb, Urb, Urb, Urb, Urb, Urb, Urb, Urb, Urb, Urb, Urb, Urb, Urb, Urb, Urb, Urb, Urb, Urb, Urb, Urb^Qov, Urb^Qov, Urb^Qov, Urb^Qov, Urb^Qov, Urb^Qov, Urb^Qov, Urb^Qov, Urb^Qov
Urb^Qov, Urb^Qov, Urb^Qov, Urb^Qov, Urb^Qov, Urb^Qov, Urb^Qov, Urb^Qov, Urb^Qov, Urb^Qov, Urb^Qov, Urb, Urb^Qov, Urb, Urb, Urb, Urb, Urb, Urb, Urb, Urb, Urb, Urb, Urb, Urb, Urb, Urb^Qov, Urb, Urb^Qov, Urb^Qov, Urb^Qov, Urb^Qov, Urb^Qov, Urb^Qov, Urb^Qov, Urb^Qov, Urb^Qov, Urb^Qov
Urb^Qov, Urb^Qov, Urb^Qov, Urb^Qov, Urb^Qov, Urb^Qov, Urb^Qov, Urb^Qov, Urb^Qov, Urb^Qov, Urb^Qov, Urb^Qov, Urb^Qov, Urb^Qov, Urb^Qov, Urb^Qov, Urb^Qov, Urb, Urb^Qov, Urb, Urb^Qov, Urb, Urb^Qov, Urb^Qov, Urb^Qov, Urb^Qov, Urb^Qov, Urb^Qov, Urb^Qov, Urb^Qov, Urb^Qov, Urb^Qov, Urb^Qov, Urb^Qov, Urb^Qov, Urb^Qov, Urb^Qov, Urb^Qov
Urb^Qov, Urb^Qov, Urb^Qov, Urb^Qov, Urb^Qov, Urb^Qov, Urb^Qov, Urb^Qov, Urb^Qov, Urb^Qov, Urb^Qov, Urb^Qov, Urb^Qov, Urb^Qov, Urb^Qov, Urb^Qov, Urb^Qov, Urb^Qov, Urb^Qov, Urb^Qov, Urb^Qov, Urb^Qov, Urb^Qov, Urb^Qov, Urb^Qov, Urb^Qov, Urb^Qov, Urb^Qov, Urb^Qov, Urb^Qov, Urb^Qov, Urb^Qov, Urb^Qov, Urb^Qov, Urb^Qov, Urb^Qov, Urb^Qov, Urb^Qov
Urb^Qov, Urb^Qov, Urb^Qov, Urb^Qov, Urb^Qov, Urb^Qov, Urb^Qov, Urb^Qov, Urb^Qov, Urb^Qov, Urb^Qov, Urb^Qov, Urb^Qov, Urb^Qov, Urb^Qov, Urb^Qov, Urb^Qov, Urb^Qov, Urb^Qov, Urb^Qov, Urb^Qov, Urb^Qov, Urb^Qov, Urb^Qov, Urb^Qov, Urb^Qov, Urb^Qov, Urb^Qov, Urb^Qov, Urb^Qov, Urb^Qov, Urb^Qov, Urb^Qov, Urb^Qov, Urb^Qov, Urb^Qov, Urb^Qov, Urb^Qov
Urb^Qov, Urb^Qov, Urb^Qov, Urb^Qov, Urb^Qov, Urb^Qov, Urb^Qov, Urb^Qov, Urb^Qov, Urb^Qov, Urb^Qov, Urb^Qov, Urb^Qov, Urb^Qov, Urb^Qov, Urb^Qov, Urb^Qov, Urb^Qov, Urb^Qov, Urb^Qov, Urb^Qov, Urb^Qov, Urb^Qov, Urb^Qov, Urb^Qov, Urb^Qov, Urb^Qov, Urb^Qov, Urb^Qov, Urb^Qov, Urb^Qov, Urb^Qov, Urb^Qov, Urb^Qov, Urb^Qov, Urb^Qov, Urb^Qov, Urb^Qov
Urb^Qov, Urb^Qov, Urb^Qov, Urb^Qov, Urb^Qov, Urb^Qov, Urb^Qov, Urb^Qov, Urb^Qov, Urb^Qov, Urb^Qov, Urb^Qov, Urb^Qov, Urb^Qov, Urb^Qov, Urb^Qov, Urb^Qov, Urb^Qov, Urb^Qov, Urb^Qov, Urb^Qov, Urb^Qov, Urb^Qov, Urb^Qov, Urb^Qov, Urb^Qov, Urb^Qov, Urb^Qov, Urb^Qov, Urb^Qov, Urb^Qov, Urb^Qov, Urb^Qov, Urb^Qov, Urb^Qov, Urb^Qov, Urb^Qov, Urb^Qov
