border_size=1
usage=map

Xv^Qov, Xv^Qov, Xv^Qov, Xv^Qov, Xv^Qov, Xv^Qov, Xv^Qov, Xv^Qov, Xv^Qov, Xv^Qov, Xv^Qov, Xv^Qov, Xv^Qov, Xv^Qov, Xv^Qov, Xv^Qov, Xv^Qov, Xv^Qov, Xv^Qov, Xv^Qov, Xv^Qov, Xv^Qov, Xv^Qov, Xv^Qov, Xv^Qov, Xv^Qov, Xv^Qov, Xv^Qov, Xv^Qov, Xv^Qov, Xv^Qov, Xv^Qov, Xv^Qov, Xv^Qov, Xv^Qov, Xv^Qov, Xv^Qov, Xv^Qov, Xv^Qov, Xv^Qov, Xv^Qov, Xv^Qov, Xv^Qov, Xv^Qov, Xv^Qov, Xv^Qov, Xv^Qov, Xv^Qov, Xv^Qov, Xv^Qov, Xv^Qov
Xv^Qov, Xv^Qov, Xv^Qov, Xv^Qov, Xv^Qov, Xv^Qov, Xv^Qov, Xv^Qov, Xv^Qov, Xv^Qov, Xv^Qov, Xv^Qov, Xv^Qov, Xv^Qov, Xv^Qov, Xv^Qov, Xv^Qov, Xv^Qov, Xv^Qov, Xv^Qov, Xv^Qov, Xv^Qov, Xv^Qov, Xv^Qov, Xv^Qov, Xv^Qov, Xv^Qov, Xv^Qov, Xv^Qov, Xv^Qov, Xv^Qov, Xv^Qov, Xv^Qov, Xv^Qov, Xv^Qov, Xv^Qov, Xv^Qov, Xv^Qov, Xv^Qov, Xv^Qov, Xv^Qov, Xv^Qov, Xv^Qov, Xv^Qov, Xv^Qov, Xv^Qov, Xv^Qov, Xv^Qov, Xv^Qov, Xv^Qov, Xv^Qov
Xv^Qov, Dd^Qov, Dd^Qov, Dd^Qov, Dd^Qov, Dd^Qov, Xv^Qov, Xv^Qov, Dd^Dr, Dd^Dr, Dd^Dr, Xv^Qov, Dd^Dr, Dd^Xo, Dd^Xo, Dd^Xo, Xv^Qov, Dd^Xo, Xv^Qov, Xv^Qov, Xv^Qov, Xv^Qov, Xv^Qov, Xv^Qov, Xv^Qov, Xv^Qov, Xv^Qov, Xv^Qov, Xv^Qov, Xv^Qov, Xv^Qov, Xv^Qov, Xv^Qov, Xv^Qov, Xv^Qov, Xv^Qov, Xv^Qov, Xv^Qov, Xv^Qov, Xv^Qov, Xv^Qov, Xv^Qov, Xv^Qov, Xv^Qov, Dd^Qov, Dd^Qov, Dd^Qov, Dd^Qov, Dd^Qov, Dd^Qov, Dd^Qov
Xv^Qov, Dd^Qov, Dd^Qov, Dd^Qov, Xv^Qov, Xv^Qov, Xv^Qov, Xv^Qov, Xv^Qov, Dd^Dr, Dd^Dr, Dd^Dr, Dd^Dr, Dd^Dr, Xv^Qov, Xv^Qov, Xv^Qov, Xv^Qov, Xv^Qov, Xv^Qov, Xv^Qov, Xv^Qov, Xv^Qov, Xv^Qov, Xv^Qov, Xv^Qov, Xv^Qov, Xv^Qov, Xv^Qov, Xv^Qov, Xv^Qov, Xv^Qov, Xv^Qov, Xv^Qov, Xv^Qov, Xv^Qov, Xv^Qov, Xv^Qov, Xv^Qov, Xv^Qov, Xv^Qov, Xv^Qov, Xv^Qov, Xv^Qov, Dd^Qov, Dd^Qov, Dd^Qov, Dd^Qov, Dd^Qov, Dd^Qov, Dd^Qov
Xv^Qov, Dd^Qov, Xv^Qov, Xv^Qov, Xv^Qov, Xv^Qov, Xv^Qov, Xv^Qov, Xv^Qov, Xv^Qov, Xv^Qov, Dd^Dr, Dd^Dr, Dd^Dr, Xv^Qov, Xv^Qov, Xv^Qov, Xv^Qov, Xv^Qov, Xv^Qov, Xv^Qov, Xv^Qov, Xv^Qov, Xv^Qov, Xv^Qov, Xv^Qov, Xv^Qov, Xv^Qov, Xv^Qov, Xv^Qov, Xv^Qov, Xv^Qov, Xv^Qov, Xv^Qov, Xv^Qov, Xv^Qov, Xv^Qov, Xv^Qov, Xv^Qov, Xv^Qov, Xv^Qov, Xv^Qov, Xv^Qov, Xv^Qov, Dd^Qov, Dd^Qov, Dd^Qov, Dd^Qov, Dd^Qov, Dd^Qov, Dd
Xv^Qov, Xv^Qov, Xv^Qov, Xv^Qov, Xv^Qov, Xv^Qov, Xv^Qov, Xv^Qov, Dd^Cov, Xv^Qov, Dd^Cov, Xv^Qov, Dd^Dr, Dd^Dr, Dd^Dr, Xv^Qov, Dd^Dr, Xv^Qov, Xv^Qov, Xv^Qov, Xv^Qov, Xv^Qov, Xv^Qov, Xv^Qov, Xv^Qov, Xv^Qov, Xv^Qov, Xv^Qov, Xv^Qov, Xv^Qov, Xv^Qov, Xv^Qov, Xv^Qov, Xv^Qov, Xv^Qov, Xv^Qov, Xv^Qov, Xv^Qov, Xv^Qov, Xv^Qov, Xv^Qov, Xv^Qov, Xv^Qov, Xv^Qov, Dd^Qov, Dd^Qov, Dd^Qov, Dd^Qov, Dd^Qov, Dd^Qov, Dd^Qov
Xv^Qov, Xv^Qov, Xv^Qov, Xv^Qov, Xv^Qov, Xv^Qov, Dd^Cov, Dd^Cov, 3 Dd^Kov, Dd^Cov, Dd^Cov, Dd^Cov, Dd^Dr, Dd^Dr, Dd^Dr, Dd^Dr, Xv^Qov, Xv^Qov, Xv^Qov, Xv^Qov, Xv^Qov, Xv^Qov, Dd^Qov, Xv^Qov, Xv^Qov, Xv^Qov, Xv^Qov, Xv^Qov, Xv^Qov, Xv^Qov, Xv^Qov, Xv^Qov, Xv^Qov, Xv^Qov, Xv^Qov, Xv^Qov, Xv^Qov, Xv^Qov, Xv^Qov, Xv^Qov, Xv^Qov, Xv^Qov, Xv^Qov, Xv^Qov, Xv^Qov, Dd^Qov, Dd^Qov, Dd^Qov, Dd^Qov, Dd^Qov, Dd^Qov
Xv^Qov, Xv^Qov, Dd^Iim, Xv^Qov, Xv^Qov, Xv^Qov, Xv^Qov, Dd^Cov, Dd^Cov, Dd^Cov, Dd, Dd, Dd^Dr, Dd^Dr, Xv^Qov, Xv^Qov, Xv^Qov, Xv^Qov, Xv^Qov, Xv^Qov, Xv^Qov, Xv^Qov, Xv^Qov, Dd^Qov, Dd^Qov, Xv^Qov, Xv^Qov, Xv^Qov, Xv^Qov, Xv^Qov, Xv^Qov, Xv^Qov, Xv^Qov, Xv^Qov, Xv^Qov, Dd^Cov, Dd^Cov, Xv^Qov, Xv^Qov, Xv^Qov, Xv^Qov, Xv^Qov, Xv^Qov, Xv^Qov, Xv^Qov, Dd^Qov, Dd^Qov, Dd^Qov, Dd^Qov, Dd^Qov, Dd^Qov
Xv^Qov, Xv^Qov, Dd^Dr, Xv^Qov, Xv^Qov, Xv^Qov, Xv^Qov, Xv^Qov, Xv^Qov, Xv^Qov, Dd, Dd^Dr, Dd^Dr, Dd^Dr, Xv^Qov, Xv^Qov, Xv^Qov, Xv^Qov, Xv^Qov, Xv^Qov, Xv^Qov, Xv^Qov, Xv^Qov, Xv^Qov, Xv^Qov, Dd^Qov, Dd^Qov, Xv^Qov, Xv^Qov, Xv^Qov, Xv^Qov, Xv^Qov, Xv^Qov, Xv^Qov, Dd^Cov, Dd^Cov, Dd^Cov, Dd^Cov, Dd^Cov, Xv^Qov, Dd^Cov, Xv^Qov, Xv^Qov, Xv^Qov, Xv^Qov, Dd^Qov, Dd^Qov, Dd^Qov, Dd^Qov, Dd^Qov, Dd^Qov
Xv^Qov, Xv^Qov, Dd^Dr, Dd^Dr, Dd^Dr, Dd^Dr, Dd, Dd, Dd, Dd, Dd, Dd, Xv^Qov, Xv^Qov, Xv^Qov, Xv^Qov, Xv^Qov, Xv^Qov, Dd^Dr, Xv^Qov, Xv^Qov, Xv^Qov, Xv^Qov, Xv^Qov, Xv^Qov, Dd^Dr, Dd^Dr, Dd^Qov, Dd^Qov, Xv^Qov, Xv^Qov, Xv^Qov, Xv^Qov, Dd^Cov, Dd^Cov, 4 Dd^Kov, Dd^Cov, Dd^Cov, Dd^Cov, Dd^Cov, Dd^Cov, Dd^Cov, Xv^Qov, Xv^Qov, Xv^Qov, Xv^Qov, Dd^Dr, Dd^Qov, Dd^Iim, Dd^Qov, Dd^Qov
Xv^Qov, Xv^Qov, Xv^Qov, Xv^Qov, Xv^Qov, Dd^Dr, Xv^Qov, Xv^Qov, Xv^Qov, Xv^Qov, Dd^Dr, Dd, Dd, Xv^Qov, Xv^Qov, Xv^Qov, Dd, Dd, Dd^Dr, Xv^Qov, Xv^Qov, Xv^Qov, Xv^Qov, Xv^Qov, Dd^Qov, Dd^Qov, Dd^Qov, Dd^Dr, Xv, Dd^Qov, Dd^Qov, Xv^Qov, Dd^Qov, Xv^Qov, Xv^Qov, Dd^Cov, Dd^Cov, Dd^Cov, Dd^Cov, Dd^Cov, Dd^Dr, Dd^Cov, Xv^Qov, Xv^Qov, Dd^Dr, Dd^Dr, Dd^Dr, Dd^Dr, Dd^Iim, Dd^Iim, Dd^Qov
Xv^Qov, Xv^Qov, Xv^Qov, Xv^Qov, Xv^Qov, Xv^Qov, Xv^Qov, Xv^Qov, Xv^Qov, Xv^Qov, Xv^Qov, Dd, Dd, Xv^Qov, Dd^Qov, Dd, Dd^Vda, Dd^Vda, Dd, Dd^Qov, Dd^Qov, Xv^Qov, Dd^Qov, Xv^Qov, Dd^Qov, Dd^Qov, Dd^Qov, Dd^Qov, Xv, Xv, Xv, Dd^Qov, Dd^Dr, Dd^Qov, Dd^Dr, Xv^Qov, Xv^Qov, Dd^Cov, Dd^Dr, Dd^Dr, Dd^Dr, Dd^Dr, Dd^Dr, Dd^Dr, Dd^Dr, Dd^Dr, Dd^Dr, Dd^Dr, Dd^Dr, Dd^Iim, Dd^Qov
Xv^Qov, Xv^Qov, Xv^Qov, Xv^Qov, Xv^Qov, Xv^Qov, Xv^Qov, Xv^Qov, Xv^Qov, Xv^Qov, Xv^Qov, Dd, Dd, Dd, Dd, Dd, Dd, Dd^Vda, Dd, Hd^Dr, Dd^Dr, Dd^Qov, Dd^Dr, Dd^Dr, Dd^Dr, Dd^Qov, Dd^Dr, Xv, Xv, Xv, Xv, Dd^Qov, Dd^Dr, Dd^Dr, Dd^Iim, Dd^Dr, Dd^Vda, Dd^Dr, Dd^Dr, Dd^Dr, Dd^Dr, Dd^Vda, Dd, Dd^Dr, Dd, Dd, Dd, Dd, Dd^Qov, Dd^Qov, Dd^Qov
Xv^Qov, Xv^Qov, Xv^Qov, Xv^Qov, Xv^Qov, Xv^Qov, Xv^Qov, Xv^Qov, Xv^Qov, Xv^Qov, Xv^Qov, Dd^Dr, Dd^Dr, Dd, Dd, Dd, Dd, Hd, Dd, Dd, Rd, Dd^Esd, Dd, Dd, Dd, Dd, Dd, Dd^Dr, Dd^Dr, Dd^Dr, Dd^Dr, Dd^Qov, Dd^Iim, Dd^Iim, Dd^Iim, Dd^Iim, Hd^Iim, Dd^Iim, Dd^Iim, Dd, Dd, Dd, Hd, Dd, Dd, Dd^Dr, Dd^Qov, Dd^Qov, Dd^Qov, Dd^Qov, Dd^Qov
Xv^Qov, Xv^Qov, Xv^Qov, Xv^Qov, Xv^Qov, Xv^Qov, Xv^Qov, Xv^Qov, Xv^Qov, Xv^Qov, Dd^Qov, Dd^Qov, Dd^Qov, Dd^Dr, Dd^Dr, Dd, Dd, Dd, Hd, Dd, Hd, Hd, Dd, Dd, Dd, Dd, Dd, Dd, Dd^Esd, Dd^Dr, Dd, Dd^Iim, Dd, Dd^Iim, Dd^Iim, Dd^Iim, Dd^Iim, Dd^Iim, Dd^Iim, Hd, Hd, Dd, Dd, Dd^Vda, Dd^Qov, Dd^Qov, Dd^Cov, 2 Dd^Kov, Dd^Qov, Dd^Qov, Dd^Qov
Xv^Qov, Xv^Qov, Xv^Qov, Xv^Qov, Xv^Qov, Xv^Qov, Xv^Qov, Xv^Qov, Dd^Qov, Dd^Qov, Dd^Qov, Dd^Qov, Dd^Qov, Dd^Qov, Dd^Qov, Dd^Dr, Hd, Dd, Dd, Dd, Dd, Hd, Dd, Dd, Dd, Dd, Dd, Dd, Dd, Dd, Dd, Rd^Iim, Dd^Iim, Dd^Iim, Dd^Iim, Dd^Qov, Dd^Qov, Dd^Vda, Dd^Iim, Hd^Iim, Dd^Iim, Dd^Iim, Dd^Qov, Dd^Qov, Dd^Cov, Dd^Cov, Dd^Cov, Dd^Qov, Dd^Qov, Dd^Qov, Dd^Qov
Xv^Qov, Xv^Qov, Xv^Qov, Xv^Qov, Xv^Qov, Xv^Qov, Xv^Qov, Xv^Qov, Dd^Qov, Dd^Qov, Dd^Qov, Dd^Qov, Dd^Qov, Dd, Dd^Qov, Dd, Dd, Dd, Dd, Dd, Dd, Dd, Dd, Dd, Rd, Rd, Rd, Dd, Dd, Dd, Dd, Dd^Iim, Dd^Vda, Dd^Iim, Dd^Iim, Dd^Qov, Dd^Qov, Dd^Qov, Dd^Iim, Dd^Iim, Dd^Iim, Dd^Iim, Dd^Qov, Dd^Cov, Dd^Cov, Dd^Cov, Dd^Cov, Dd^Qov, Dd^Qov, Dd^Qov, Dd^Qov
Xv^Qov, Xv^Qov, Xv^Qov, Xv^Qov, Xv^Qov, Xv^Qov, Xv^Qov, Xv^Qov, Dd^Qov, Dd^Qov, Dd^Dr, Dd^Qov, Dd^Qov, Dd^Dr, Dd^Dr, Dd, Xv^Qov, Xv^Qov, Xv^Qov, Dd, Rd, Dd, Rd, Rd, Rd, Rd, Rd, Rd, Rd, Rd, Rd, Rd, Rd, Dd^Iim, Dd^Iim, Dd^Iim, Dd^Iim, Dd^Qov, Dd^Iim, Dd^Vda, Dd^Dr, Dd^Dr, Dd^Qov, Dd^Cov, Dd, Dd^Xo, Dd, Dd^Qov, Dd^Qov, Dd^Qov, Dd^Qov
Xv^Qov, Xv^Qov, Xv^Qov, Xv^Qov, Xv^Qov, Xv^Qov, Xv^Qov, Xv^Qov, Dd^Qov, Dd^Dr, Dd^Dr, Dd^Dr, Dd^Dr, Dd^Qov, Dd^Dr, Dd^Dr, Dd, Xv^Qov, Xv^Qov, Xv^Qov, Xv^Qov, Rd, Rd, Rd, Rd, Rd, Rd, Rd, Rd, Rd, Rd, Rd, Dd, Dd^Iim, Hd^Iim, Dd^Iim, Dd^Iim, Dd^Iim, Dd^Iim, Dd^Dr, Dd, Dd, Dd, Dd, Dd, Dd, Dd, Dd^Qov, Dd^Qov, Dd^Qov, Dd^Qov
Xv^Qov, Xv^Qov, Xv^Qov, Xv^Qov, Xv^Qov, Xv^Qov, Xv^Qov, Xv^Qov, Dd^Qov, Dd^Dr, Dd^Dr, Dd^Dr, Dd, Dd^Dr, Dd, Dd^Esd, Dd, Dd, Dd, Xv^Qov, Dd^Xo, Dd^Xo, Xv^Qov, Rd, Xv^Qov, Rd^Kov, Rd^Kov, Rd, Rd, Rd, Rd, Dd, Dd, Dd, Dd, Dd^Iim, Dd, Dd^Dr, Dd^Dr, Dd^Dr, Dd, Dd, Dd, Dd, Dd, Dd, Dd, Dd^Qov, Dd^Qov, Dd^Qov, Dd^Qov
Xv^Qov, Xv^Qov, Xv^Qov, Xv^Qov, Xv^Qov, Xv^Qov, Xv^Qov, Xv^Qov, Dd^Dr, Dd^Dr, Dd, Dd, Dd, Dd, Dd, Dd, Dd, Dd, Rd, Rd, Rd, Xv^Qov, Xv^Qov, Xv^Qov, Xv^Qov, Rp^Kov, Rp^Kov, Rp^Kov, Rp^Kov, Rd, Rd, Rd, Dd, Dd, Dd, Dd, Hd^Dr, Dd^Dr, Hd^Dr, Dd^Dr, Dd, Dd, Dd, Dd, Dd^Qov, Dd, Dd^Qov, Dd^Qov, Dd^Qov, Dd^Qov, Dd^Qov
Xv^Qov, Xv^Qov, Xv^Qov, Xv^Qov, Xv^Qov, Xv^Qov, Xv^Qov, Xv^Qov, Dd^Dr, Dd^Dr, Hd, Dd, Dd, Dd^Esd, Dd^Vda, Dd, Rd, Rd, Rd, Rd, Rd, Rp^Kov, Rp^Kov, Xv^Qov, Rp^Kov, 1 Rp^Kov, Rp^Kov, Rp^Kov, Rp^Kov, Rp^Kov, Rd, Rd, Rd, Dd, Dd, Dd^Dr, Hd^Dr, Dd^Dr, Dd^Qov, Dd, Dd^Qov, Dd^Qov, Dd^Qov, Dd^Qov, Dd^Qov, Dd^Qov, Dd^Qov, Dd^Qov, Dd^Qov, Dd^Qov, Dd
Xv^Qov, Xv^Qov, Xv^Qov, Xv^Qov, Xv^Qov, Xv^Qov, Xv^Qov, Xv^Qov, Dd^Dr, Dd^Dr, Dd^Dr, Dd, Dd, Dd, Dd, Dd, Dd, Dd, Dd, Dd, Dd, Rd, Rd, Rp^Kov, Rd^Kov, Rp^Kov, Rd^Xo, Rp^Kov, Rd, Rd, Rd, Rd, Rd, Rd, Dd, Dd^Vda, Dd, Hd^Dr, Dd^Dr, Dd^Qov, Dd^Qov, Dd^Qov, Dd^Dr, Dd^Qov, Dd^Qov, Dd^Qov, Dd^Qov, Dd^Qov, Dd^Dr, Dd^Qov, Dd
Xv^Qov, Xv^Qov, Xv^Qov, Xv^Qov, Xv^Qov, Xv^Qov, Xv^Qov, Xv^Qov, Dd^Qov, Dd^Dr, Hd, Dd, Dd, Dd, Hd, Dd, Dd, Dd, Dd, Dd, Dd, Rd, Rd, Rd, Rd, Rd, Rd, Rd, Rd, Rd, Rd, Rd, Rd, Dd, Dd, Dd, Dd, Dd, Dd, Dd^Dr, Dd^Dr, Dd^Dr, Dd^Dr, Dd^Dr, Dd^Dr, Dd^Dr, Dd^Dr, Dd^Dr, Dd^Dr, Dd^Dr, Dd
Xv^Qov, Xv^Qov, Xv^Qov, Xv^Qov, Xv^Qov, Xv^Qov, Xv^Qov, Xv^Qov, Xv^Qov, Dd^Qov, Dd^Qov, Dd^Dr, Dd^Dr, Hd, Hd, Dd, Dd, Dd^Esd, Dd, Dd, Dd, Rd, Dd, Dd, Dd, Rd, Rd, Rd, Rd, Rd, Rd, Rd, Rd, Dd, Dd, Dd, Dd, Dd, Dd, Dd^Dr, Dd^Dr, Dd^Dr, 5 Dd^Do, Dd^Dr, Dd^Dr, Dd^Dr, Dd^Dr, Dd^Dr, Dd^Dr, Dd^Dr, Dd
Xv^Qov, Xv^Qov, Xv^Qov, Xv^Qov, Xv^Qov, Xv^Qov, Xv^Qov, Xv^Qov, Xv^Qov, Xv^Qov, Xv^Qov, Dd^Qov, Dd^Qov, Dd, Dd, Hd, Dd, Dd, Dd^Vda, Dd, Dd^Esd, Dd, Dd, Dd, Dd, Rd, Rd, Rd, Dd^Esd, Dd, Dd, Dd, Dd^Vda, Dd, Dd, Dd, Dd, Dd, Dd, Dd, Dd, Dd, Hd, Dd^Dr, Dd^Dr, Dd^Dr, Dd^Dr, Dd^Dr, Dd^Dr, Dd^Dr, Dd
Xv^Qov, Xv^Qov, Xv^Qov, Xv^Qov, Xv^Qov, Xv^Qov, Xv^Qov, Xv^Qov, Xv^Qov, Xv^Qov, Xv^Qov, Xv^Qov, Xv^Qov, Dd^Qov, Dd^Qov, Dd, Dd, Dd, Dd, Dd, Dd, Dd, Dd, Dd, Dd^Vda, Rd, Dd, Dd, Dd, Dd, Dd, Dd, Dd, Dd, Dd, Dd, Dd, Dd, Dd, Dd, Dd, Dd, Dd, Dd, Dd, Dd^Dr, Dd^Dr, Dd^Dr, Dd^Dr, Dd^Dr, Dd
Xv^Qov, Xv^Qov, Xv^Qov, Xv^Qov, Xv^Qov, Xv^Qov, Xv^Qov, Xv^Qov, Xv^Qov, Xv^Qov, Xv^Qov, Xv^Qov, Xv^Qov, Xv^Qov, Xv^Qov, Dd^Qov, Dd, Dd, Dd, Dd, Dd, Dd, Dd, Dd, Dd, Dd, Dd, Dd, Dd, Dd, Dd, Dd, Dd, Dd, Dd, Dd, Dd, Dd, Dd, Dd, Dd, Dd, Dd, Dd, Dd, Dd, Dd, Dd, Dd, Dd, Dd
