Xv, Xv, Xv, Xv, Xv, Xv, Xv, Xv, Xv, Xv, Xv, Xv, Xv, Xv, Xv, Xv, Xv, Xv, Xv, Xv, Xv, Xv, Xv, Xv, Xv, Xv, Xv, Xv, Xv, Xv, Xv, Xv, Xv, Xv, Xv, Xv, Xv, Xv, Xv
Xv, 2 Xv, Xv, Xv, Xv, Xv, Qxu, Xv, Qxu, Xv, Qxu, Xv, Uh, Xv, Uh, Xv, Uh, Xv, Uh, Xv, Uh, Xv, Urb, Xv, Uh, Xv, Uh, Xv, Qxu, Xv, Qxu, Xv, Qxu, Xv, Xv, Xv, Xv, Xv, Xv
Xv, Xv, Xv, Xv, Xv, Qxu, Qxu, Qxu, Qxu, Qxu, Qxu, Uh, Uh, Uh, Uh, Uh, Uh, Uh, Uh, Uh, Uh, Uh, Uh, Uh, Uh, Uh, Uh, Uh, Uh, Qxu, Qxu, Qxu, Qxu, Qxu, Xv, Xv, Xv, Xv, Xv
Xv, Xv, Xv, Xv, Qxu, Qxu, Qxu, Qxu, Urb, Qxu, Qxu, Uh, Uh, Uh, Uh, Uh, Uh, Uh, Uh, Uh, Uh, Uh, Uh, Uh, Uh, Uh, Uh, Uh, Uh, Uh, Uh, Qxu, Qxu, Qxu, Qxu, Xv, Xv, Xv, Xv
Xv, Xv, Xv, Qxu, Qxu, Qxu, Qxu, Qxu, Qxu, Urb, Urb, Qxu, Uh, Uh, Uh, Uh, Uh, Uh, Uh, Uh, Uh, Uh, Uh, Uh, Uh, Uh, Uh, Uh, Uh, Uh, Qxu, Qxu, Qxu, Qxu, Qxu, Qxu, Xv, Xv, Xv
Xv, Xv, Xv, Qxu, Qxu, Qxu, Qxu, Qxu, Qxu, Urb, Urb, Urb, Uh, Uh, Uh, Uh, Uh, Uh, Uh, Uh, Uh, Uh, Uh, Uh, Uh, Uh, Uh, Uh, Urb, Urb, Qxu, Qxu, Qxu, Qxu, Qxu, Qxu, Xv, Xv, Xv
Xv, Xv, Qxu, Qxu, Urb, Qxu, Urb, Qxu, Qxu, Qxu, Urb, Urb, Urb, Uh, Uh, Uh, Uh, Uh, Uh, Uh, Uh, Uh, Uh, Uh, Uh, Uh, Urb, Urb, Urb, Qxu, Qxu, Qxu, Urb, Qxu, Urb, Qxu, Qxu, Xv, Xv
Xv, Xv, Qxu, Qxu, Qxu, Urb, Urb, Urb, Urb, Urb, Urb, Urb, Urb, Uh, Uh, Uh, Uh, Uh, Uh, Uh, Uh, Uh, Urb, Uh, Uh, Uh, Urb, Urb, Urb, Urb, Urb, Urb, Urb, Urb, Qxu, Qxu, Qxu, Xv, Xv
Xv, Xv, Qxu, Qxu, Qxu, Qxu, Qxu, Urb, Urb, Urb, Urb, Urb, Urb, Urb, Urb, Uh, Uh, Uh, Uh, Uh, Uh, Uh, Urb, Urb, Urb, Urb, Urb, Urb, Urb, Urb, Urb, Urb, Qxu, Qxu, Qxu, Qxu, Qxu, Xv, Xv
Xv, Xv, Urb, Qxu, Urb, Qxu, Urb, Urb, Urb, Urb, Urb, Urb, Urb^Iiz, Urb, Urb, Uh, Uh, Uh, Xv, Xv, Xv, Urb, Urb, Urb, Urb, Urb, Urb^Iiz, Urb, Urb, Urb, Urb, Urb, Urb, Qxu, Urb, Qxu, Urb, Xv, Xv
Xv, Xv, Qxu, Urb, Qxu, Urb, Urb, Urb, Urb, Urb, Urb, Urb, Urb, Urb, Urb, Urb, Urb, Xv, Xv, Xv, Xv, Xv, Urb, Urb, Urb, Urb, Urb, Urb, Urb, Urb, Urb, Urb, Urb, Urb, Qxu, Urb, Xv, Xv, Xv
Xv, Xv, Xv, Qxu, Qxu, Qxu, Urb, Urb^Iiz, Urb^Iiz, Urb^Iiz, Urb, Urb, Urb, Urb, Urb, Urb, Urb, Urb, Urb, Xv, Urb, Urb, Urb, Urb, Urb, Urb, Urb, Urb, Urb, Urb^Iiz, Urb^Iiz, Urb^Iiz, Urb, Qxu, Qxu, Qxu, Xv, Xv, Xv
Xv, Xv, Xv, Qxu, Qxu, Qxu, Qxu, Urb, Urb, Urb, Urb, Urb, Ql, Ql, Urb, Urb, Urb, Urb, Urb, Urb, Urb, Urb, Urb, Urb, Urb, Ql, Ql, Urb, Urb, Urb, Urb, Urb, Qxu, Qxu, Qxu, Qxu, Xv, Xv, Xv
Xv, Xv, Xv, Xv, Qxu, Qxu, Qxu, Urb, Urb, Urb, Urb, Urb, Urb, Urb, Urb, Urb, Urb, Urb, Urb, Urb, Urb, Urb, Urb, Urb, Urb, Urb, Urb, Urb, Urb, Urb, Urb, Urb, Qxu, Qxu, Qxu, Xv, Xv, Xv, Xv
Xv, Xv, Xv, Xv, Xv, Qxu, Qxu, Qxu, Urb, Urb, Urb, Urb, Urb, Urb, Urb, Urb^Iiz, Urb, Urb, Urb, Urb, Urb, Urb, Urb, Urb^Iiz, Urb, Urb, Urb, Urb, Urb, Urb, Urb, Qxu, Qxu, Qxu, Xv, Xv, Xv, Xv, Xv
Xv, Xv, Xv, Xv, Xv, Xv, Xv, Qxu, Qxu, Urb, Urb, Urb, Urb, Urb, Urb, Urb, Ql, Urb, Urb, Urb, Urb, Urb, Ql, Urb, Urb, Urb, Urb, Urb, Urb, Urb, Qxu, Qxu, Xv, Xv, Xv, Xv, Xv, Xv, Xv
Xv, Xv, Xv, Xv, Xv, Xv, Xv, Xv, Xv, Qxu, Qxu, Urb, Qxu, Urb, Ql, Ql, Ql, Ql, Urb, Urb, Urb, Ql, Ql, Ql, Ql, Urb, Qxu, Urb, Qxu, Qxu, Xv, Xv, Xv, Xv, Xv, Xv, Xv, Xv, Xv
Xv, Xv, Xv, Xv, Xv, Xv, Xv, Xv, Xv, Xv, Xv, Qxu, Xv, Qxu, Qxu, Ql, Xv, Qxu, Urb, Urb, Urb, Qxu, Xv, Ql, Qxu, Qxu, Qxu, Qxu, Xv, Xv, Xv, Xv, Xv, Xv, Xv, Xv, Xv, Xv, Xv
Xv, Xv, Xv, Xv, Xv, Xv, Xv, Xv, Xv, Xv, Xv, Xv, Xv, Xv, Xv, Xv, Xv, Xv, Xv, Xv, Xv, Xv, Xv, Xv, Xv, Xv, Xv, Xv, Xv, Xv, Xv, Xv, Xv, Xv, Xv, Xv, Xv, Xv, Xv
Xv, Xv, Xv, Xv, Xv, Xv, Xv, Xv, Xv, Xv, Xv, Xv, Xv, Xv, Xv, Xv, Xv, Xv, Urb, Urb, Urb, Xv, Xv, Xv, Xv, Xv, Xv, Xv, Xv, Xv, Xv, Xv, Xv, Xv, Xv, Xv, Xv, Xv, Xv
Xv, Xv, Xv, Xv, Xv, Xv, Xv, Xv, Xv, Xv, Xv, Xv, Xv, Xv, Xv, Xv, Xv, Xv, Urb, Urb, Urb, Xv, Xv, Xv, Xv, Xv, Xv, Xv, Xv, Xv, Xv, Xv, Xv, Xv, Xv, Xv, Xv, Xv, Xv
Xv, Xv, Xv, Xv, Xv, Xv, Xv, Xv, Xv, Xv, Xv, Xv, Xv, Xv, Xv, Xv, Xv, Xv, Urb, Urb, Urb, Xv, Xv, Xv, Xv, Xv, Xv, Xv, Xv, Xv, Xv, Xv, Xv, Xv, Xv, Xv, Xv, Xv, Xv
Xv, Xv, Xv, Xv, Xv, Xv, Xv, Xv, Xv, Xv, Xv, Xv, Xv, Xv, Xv, Xv, Xv, Xv, Urb, Urb, Urb, Xv, Xv, Xv, Xv, Xv, Xv, Xv, Xv, Xv, Xv, Xv, Xv, Xv, Xv, Xv, Xv, Xv, Xv
Xv, Xv, Xv, Xv, Xv, Xv, Xv, Xv, Xv, Xv, Xv, Xv, Xv, Xv, Xv, Xv, Xv, Xv, Urb, Urb, Urb, Xv, Xv, Xv, Xv, Xv, Xv, Xv, Xv, Xv, Xv, Xv, Xv, Xv, Xv, Xv, Xv, Xv, Xv
Xv, Xv, Xv, Xv, Xv, Xv, Xv, Xv, Xv, Xv, Xv, Xv, Xv, Xv, Xv, Xv, Xv, Xv, Urb, Urb, Urb, Xv, Xv, Xv, Xv, Xv, Xv, Xv, Xv, Xv, Xv, Xv, Xv, Xv, Xv, Xv, Xv, Xv, Xv
Xv, Xv, Xv, Xv, Xv, Xv, Xv, Xv, Xv, Xv, Xv, Xv, Xv, Xv, Xv, Xv, Xv, Xv, Urb, Urb, Urb, Xv, Xv, Xv, Xv, Xv, Xv, Xv, Xv, Xv, Xv, Xv, Xv, Xv, Xv, Xv, Xv, Xv, Xv
Xv, Xv, Xv, Xv, Xv, Xv, Xv, Xv, Xv, Xv, Xv, Xv, Xv, Xv, Xv, Xv, Xv, Xv, Aa, 1 Urb, Urb, Xv, Xv, Xv, Xv, Xv, Xv, Xv, Xv, Xv, Xv, Xv, Xv, Xv, Xv, Xv, Xv, Xv, Xv
Xv, Xv, Xv, Xv, Xv, Xv, Xv, Xv, Xv, Xv, Xv, Xv, Xv, Xv, Xv, Xv, Xv, Xv, Aa, Urb, Aa, Xv, Xv, Xv, Xv, Xv, Xv, Xv, Xv, Xv, Xv, Xv, Xv, Xv, Xv, Xv, Xv, Xv, Xv
Xv, Xv, Xv, Xv, Xv, Xv, Xv, Xv, Xv, Xv, Xv, Xv, Xv, Xv, Xv, Xv, Xv, Xv, Xv, Aa, Xv, Xv, Xv, Xv, Xv, Xv, Xv, Xv, Xv, Xv, Xv, Xv, Xv, Xv, Xv, Xv, Xv, Xv, Xv
Xv, Xv, Xv, Xv, Xv, Xv, Xv, Xv, Xv, Xv, Xv, Xv, Xv, Xv, Xv, Xv, Xv, Xv, Xv, Xv, Xv, Xv, Xv, Xv, Xv, Xv, Xv, Xv, Xv, Xv, Xv, Xv, Xv, Xv, Xv, Xv, Xv, Xv, Xv
